id,name,price_m,price_m_prev,Δ_price_m,transfers_net_event,transfers_net_event_prev,web_name,now_cost,cost_change_event,transfers_in_event,transfers_out_event,selected_by_percent,web_name_prev,now_cost_prev,cost_change_event_prev,transfers_in_event_prev,transfers_out_event_prev,selected_by_percent_prev,Δ_now_cost,Δ_cost_change_event,Δ_transfers_in_event,Δ_transfers_out_event,Δ_selected_by_percent
1,Raya,5.5,5.5,0.0,191085,191085,Raya,55,0,242927,51842,20.7,Raya,55,0,242927,51842,20.7,0,0,0,0,0.0
2,Arrizabalaga,4.5,4.5,0.0,-8835,-8835,Arrizabalaga,45,0,2019,10854,0.8,Arrizabalaga,45,0,2019,10854,0.8,0,0,0,0,0.0
3,Hein,4.0,4.0,0.0,-1069,-1069,Hein,40,0,3531,4600,0.6,Hein,40,0,3531,4600,0.6,0,0,0,0,0.0
4,Setford,4.0,4.0,0.0,-467,-467,Setford,40,0,895,1362,0.2,Setford,40,0,895,1362,0.2,0,0,0,0,0.0
5,Gabriel,6.0,6.0,0.0,200041,200041,Gabriel,60,0,271631,71590,20.6,Gabriel,60,0,271631,71590,20.6,0,0,0,0,0.0
6,Saliba,6.0,6.0,0.0,201087,201087,Saliba,60,0,257225,56138,17.3,Saliba,60,0,257225,56138,17.3,0,0,0,0,0.0
7,Calafiori,5.5,5.5,0.0,194290,194290,Calafiori,55,0,216470,22180,4.0,Calafiori,55,0,216470,22180,4.0,0,0,0,0,0.0
8,J.Timber,5.5,5.5,0.0,-21236,-21236,J.Timber,55,0,12302,33538,2.1,J.Timber,55,0,12302,33538,2.1,0,0,0,0,0.0
9,Kiwior,5.5,5.5,0.0,-1562,-1562,Kiwior,55,0,344,1906,0.1,Kiwior,55,0,344,1906,0.1,0,0,0,0,0.0
10,Lewis-Skelly,5.5,5.5,0.0,-47614,-47614,Lewis-Skelly,55,0,18013,65627,3.8,Lewis-Skelly,55,0,18013,65627,3.8,0,0,0,0,0.0
11,White,5.5,5.5,0.0,12563,12563,White,55,0,19628,7065,1.1,White,55,0,19628,7065,1.1,0,0,0,0,0.0
12,Zinchenko,5.0,5.0,0.0,-3210,-3210,Zinchenko,50,0,2874,6084,0.4,Zinchenko,50,0,2874,6084,0.4,0,0,0,0,0.0
13,Clarke,4.0,4.0,0.0,-1471,-1471,Clarke,40,0,5789,7260,0.6,Clarke,40,0,5789,7260,0.6,0,0,0,0,0.0
14,Kacurri,4.0,4.0,0.0,-1072,-1072,Kacurri,40,0,1372,2444,0.2,Kacurri,40,0,1372,2444,0.2,0,0,0,0,0.0
15,Nichols,4.0,4.0,0.0,-1045,-1045,Nichols,40,0,1026,2071,0.2,Nichols,40,0,1026,2071,0.2,0,0,0,0,0.0
16,Saka,10.0,10.0,0.0,25630,25630,Saka,100,0,121795,96165,17.1,Saka,100,0,121795,96165,17.1,0,0,0,0,0.0
17,Ødegaard,8.0,8.0,0.0,10808,10808,Ødegaard,80,0,41599,30791,3.9,Ødegaard,80,0,41599,30791,3.9,0,0,0,0,0.0
18,Madueke,7.0,7.0,0.0,-14245,-14245,Madueke,70,0,3149,17394,1.0,Madueke,70,0,3149,17394,1.0,0,0,0,0,0.0
19,Martinelli,7.0,7.0,0.0,-8505,-8505,Martinelli,70,0,8311,16816,1.4,Martinelli,70,0,8311,16816,1.4,0,0,0,0,0.0
20,Trossard,7.0,7.0,0.0,-5801,-5801,Trossard,70,0,754,6555,0.3,Trossard,70,0,754,6555,0.3,0,0,0,0,0.0
21,Rice,6.5,6.5,0.0,17540,17540,Rice,65,0,78250,60710,8.3,Rice,65,0,78250,60710,8.3,0,0,0,0,0.0
22,Merino,6.0,6.0,0.0,-11195,-11195,Merino,60,0,4140,15335,0.6,Merino,60,0,4140,15335,0.6,0,0,0,0,0.0
23,Fábio Vieira,5.5,5.5,0.0,-454,-454,Fábio Vieira,55,0,458,912,0.0,Fábio Vieira,55,0,458,912,0.0,0,0,0,0,0.0
24,Nørgaard,5.5,5.5,0.0,-16270,-16270,Nørgaard,55,0,1116,17386,0.5,Nørgaard,55,0,1116,17386,0.5,0,0,0,0,0.0
25,Nwaneri,5.5,5.5,0.0,-4845,-4845,Nwaneri,55,0,1569,6414,0.3,Nwaneri,55,0,1569,6414,0.3,0,0,0,0,0.0
26,Zubimendi,5.5,5.5,0.0,2340,2340,Zubimendi,55,0,31943,29603,2.3,Zubimendi,55,0,31943,29603,2.3,0,0,0,0,0.0
27,Nelson,5.0,5.0,0.0,-1252,-1252,Nelson,50,0,1393,2645,0.1,Nelson,50,0,1393,2645,0.1,0,0,0,0,0.0
28,Kabia,4.5,4.5,0.0,-1378,-1378,Kabia,45,0,3461,4839,0.3,Kabia,45,0,3461,4839,0.3,0,0,0,0,0.0
29,Sambi,4.5,4.5,0.0,-707,-707,Sambi,45,0,1513,2220,0.1,Sambi,45,0,1513,2220,0.1,0,0,0,0,0.0
30,Havertz,7.5,7.5,0.0,-27291,-27291,Havertz,75,0,7891,35182,1.0,Havertz,75,0,7891,35182,1.0,0,0,0,0,0.0
31,G.Jesus,6.5,6.5,0.0,-742,-742,G.Jesus,65,0,225,967,0.0,G.Jesus,65,0,225,967,0.0,0,0,0,0,0.0
662,Mosquera,5.5,5.5,0.0,-1651,-1651,Mosquera,55,0,386,2037,0.1,Mosquera,55,0,386,2037,0.1,0,0,0,0,0.0
666,Gyökeres,9.0,9.0,0.0,-71472,-71472,Gyökeres,90,0,170206,241678,24.8,Gyökeres,90,0,170206,241678,24.8,0,0,0,0,0.0
32,Martinez,5.0,5.0,0.0,12916,12916,Martinez,50,0,19572,6656,1.1,Martinez,50,0,19572,6656,1.1,0,0,0,0,0.0
33,M.Bizot,4.5,4.5,0.0,32736,32736,M.Bizot,45,0,45805,13069,0.9,M.Bizot,45,0,45805,13069,0.9,0,0,0,0,0.0
34,Gauci,4.0,4.0,0.0,-3699,-3699,Gauci,40,0,0,3699,0.2,Gauci,40,0,0,3699,0.2,0,0,0,0,0.0
35,Marschall,4.0,4.0,0.0,-312,-312,Marschall,40,0,0,312,0.0,Marschall,40,0,0,312,0.0,0,0,0,0,0.0
36,Cash,4.5,4.5,0.0,200038,200038,Cash,45,0,235521,35483,4.7,Cash,45,0,235521,35483,4.7,0,0,0,0,0.0
37,Digne,4.5,4.5,0.0,34884,34884,Digne,45,0,47284,12400,2.3,Digne,45,0,47284,12400,2.3,0,0,0,0,0.0
38,Konsa,4.5,4.5,0.0,-453338,-453338,Konsa,45,0,18644,471982,16.6,Konsa,45,0,18644,471982,16.6,0,0,0,0,0.0
39,Maatsen,4.5,4.5,0.0,-10341,-10341,Maatsen,45,0,3339,13680,0.8,Maatsen,45,0,3339,13680,0.8,0,0,0,0,0.0
40,Mings,4.5,4.5,0.0,30831,30831,Mings,45,0,39240,8409,1.3,Mings,45,0,39240,8409,1.3,0,0,0,0,0.0
41,Pau,4.5,4.5,0.0,-3601,-3601,Pau,45,0,3309,6910,0.5,Pau,45,0,3309,6910,0.5,0,0,0,0,0.0
42,A.García,4.0,4.0,0.0,-4443,-4443,A.García,40,0,433,4876,0.3,A.García,40,0,433,4876,0.3,0,0,0,0,0.0
43,Alex Moreno,4.0,4.0,0.0,-49991,-49991,Alex Moreno,40,0,29589,79580,9.2,Alex Moreno,40,0,29589,79580,9.2,0,0,0,0,0.0
44,Bogarde,4.0,4.0,0.0,-1310,-1310,Bogarde,40,0,1664,2974,0.3,Bogarde,40,0,1664,2974,0.3,0,0,0,0,0.0
45,Sousa,4.0,4.0,0.0,-1085,-1085,Sousa,40,0,1936,3021,0.4,Sousa,40,0,1936,3021,0.4,0,0,0,0,0.0
46,Yasin,4.0,4.0,0.0,-1079,-1079,Yasin,40,0,1088,2167,0.2,Yasin,40,0,1088,2167,0.2,0,0,0,0,0.0
47,Rogers,7.0,7.0,0.0,-20008,-20008,Rogers,70,0,88112,108120,9.7,Rogers,70,0,88112,108120,9.7,0,0,0,0,0.0
48,Tielemans,6.0,6.0,0.0,-15718,-15718,Tielemans,60,0,16266,31984,2.2,Tielemans,60,0,16266,31984,2.2,0,0,0,0,0.0
49,Bailey,5.5,5.5,0.0,-15581,-15581,Bailey,55,0,2168,17749,0.4,Bailey,55,0,2168,17749,0.4,0,0,0,0,0.0
50,Buendía,5.4,5.4,0.0,-4265,-4265,Buendía,54,-1,423,4688,0.1,Buendía,54,-1,423,4688,0.1,0,0,0,0,0.0
51,Iling Jr,5.5,5.5,0.0,-361,-361,Iling Jr,55,0,160,521,0.0,Iling Jr,55,0,160,521,0.0,0,0,0,0,0.0
53,Malen,5.4,5.4,0.0,-37974,-37974,Malen,54,-1,4955,42929,1.5,Malen,54,-1,4955,42929,1.5,0,0,0,0,0.0
54,McGinn,5.5,5.5,0.0,-1631,-1631,McGinn,55,0,7857,9488,0.7,McGinn,55,0,7857,9488,0.7,0,0,0,0,0.0
55,Barkley,5.0,5.0,0.0,-2601,-2601,Barkley,50,0,86,2687,0.1,Barkley,50,0,86,2687,0.1,0,0,0,0,0.0
56,Barrenechea,5.0,5.0,0.0,-10,-10,Barrenechea,50,0,0,10,0.0,Barrenechea,50,0,0,10,0.0,0,0,0,0,0.0
57,Dobbin,5.0,5.0,0.0,-478,-478,Dobbin,50,0,524,1002,0.1,Dobbin,50,0,524,1002,0.1,0,0,0,0,0.0
58,Kamara,5.0,5.0,0.0,-453,-453,Kamara,50,0,2785,3238,0.2,Kamara,50,0,2785,3238,0.2,0,0,0,0,0.0
59,Onana,5.0,5.0,0.0,14679,14679,Onana,50,0,36560,21881,1.9,Onana,50,0,36560,21881,1.9,0,0,0,0,0.0
60,Broggio,4.5,4.5,0.0,-972,-972,Broggio,45,0,3030,4002,0.3,Broggio,45,0,3030,4002,0.3,0,0,0,0,0.0
61,Dendoncker,4.5,4.5,0.0,-4273,-4273,Dendoncker,45,0,2169,6442,0.3,Dendoncker,45,0,2169,6442,0.3,0,0,0,0,0.0
62,Jimoh-Aloba,4.5,4.5,0.0,-250,-250,Jimoh-Aloba,45,0,432,682,0.1,Jimoh-Aloba,45,0,432,682,0.1,0,0,0,0,0.0
63,Young,4.5,4.5,0.0,-3114,-3114,Young,45,0,6036,9150,0.7,Young,45,0,6036,9150,0.7,0,0,0,0,0.0
64,Watkins,9.0,9.0,0.0,-129395,-129395,Watkins,90,0,121309,250704,25.3,Watkins,90,0,121309,250704,25.3,0,0,0,0,0.0
65,Redmond,4.5,4.5,0.0,-1262,-1262,Redmond,45,0,9915,11177,0.9,Redmond,45,0,9915,11177,0.9,0,0,0,0,0.0
677,Guessand,6.5,6.5,0.0,-1441,-1441,Guessand,65,0,358,1799,0.1,Guessand,65,0,358,1799,0.1,0,0,0,0,0.0
688,Wright,4.0,4.0,0.0,9825,9825,Wright,40,0,11225,1400,0.5,Wright,40,0,11225,1400,0.5,0,0,0,0,0.0
183,Weiss,4.5,4.5,0.0,-1257,-1257,Weiss,45,0,610,1867,0.2,Weiss,45,0,610,1867,0.2,0,0,0,0,0.0
184,Green,4.0,4.0,0.0,-65,-65,Green,40,0,2239,2304,0.4,Green,40,0,2239,2304,0.4,0,0,0,0,0.0
185,Hladký,4.0,4.0,0.0,-570,-570,Hladký,40,0,716,1286,0.2,Hladký,40,0,716,1286,0.2,0,0,0,0,0.0
186,Roberts,4.5,4.5,0.0,-869,-869,Roberts,45,0,415,1284,0.1,Roberts,45,0,415,1284,0.1,0,0,0,0,0.0
187,Walker,4.5,4.5,0.0,-3667,-3667,Walker,45,0,14610,18277,1.9,Walker,45,0,14610,18277,1.9,0,0,0,0,0.0
188,Delcroix,4.0,4.0,0.0,-1865,-1865,Delcroix,40,0,1067,2932,0.3,Delcroix,40,0,1067,2932,0.3,0,0,0,0,0.0
189,Dodgson,4.0,4.0,0.0,-804,-804,Dodgson,40,0,0,804,0.0,Dodgson,40,0,0,804,0.0,0,0,0,0,0.0
190,Ekdal,4.0,4.0,0.0,2037,2037,Ekdal,40,0,4312,2275,0.3,Ekdal,40,0,4312,2275,0.3,0,0,0,0,0.0
191,Estève,4.0,4.0,0.0,-919,-919,Estève,40,0,75049,75968,19.6,Estève,40,0,75049,75968,19.6,0,0,0,0,0.0
192,Hartman,4.0,4.0,0.0,1981,1981,Hartman,40,0,6054,4073,0.6,Hartman,40,0,6054,4073,0.6,0,0,0,0,0.0
193,Humphreys,4.0,4.0,0.0,-868,-868,Humphreys,40,0,116,984,0.1,Humphreys,40,0,116,984,0.1,0,0,0,0,0.0
194,Jordan,4.0,4.0,0.0,-1175,-1175,Jordan,40,0,540,1715,0.2,Jordan,40,0,540,1715,0.2,0,0,0,0,0.0
195,Lucas Pires,4.0,4.0,0.0,-1296,-1296,Lucas Pires,40,0,274,1570,0.2,Lucas Pires,40,0,274,1570,0.2,0,0,0,0,0.0
196,Sambo,4.0,4.0,0.0,-1789,-1789,Sambo,40,0,202,1991,0.1,Sambo,40,0,202,1991,0.1,0,0,0,0,0.0
197,Sonne,4.0,4.0,0.0,104,104,Sonne,40,0,1368,1264,0.2,Sonne,40,0,1368,1264,0.2,0,0,0,0,0.0
198,Tuanzebe,4.0,4.0,0.0,-16648,-16648,Tuanzebe,40,0,3175,19823,2.3,Tuanzebe,40,0,3175,19823,2.3,0,0,0,0,0.0
199,Worrall,4.0,4.0,0.0,-1038,-1038,Worrall,40,0,321,1359,0.1,Worrall,40,0,321,1359,0.1,0,0,0,0,0.0
200,Anthony,5.5,5.5,0.0,298,298,Anthony,55,0,2032,1734,0.1,Anthony,55,0,2032,1734,0.1,0,0,0,0,0.0
201,Benson,5.5,5.5,0.0,-319,-319,Benson,55,0,110,429,0.0,Benson,55,0,110,429,0.0,0,0,0,0,0.0
202,Bruun Larsen,5.5,5.5,0.0,-545,-545,Bruun Larsen,55,0,223,768,0.0,Bruun Larsen,55,0,223,768,0.0,0,0,0,0,0.0
203,Boateng,5.0,5.0,0.0,-638,-638,Boateng,50,0,233,871,0.1,Boateng,50,0,233,871,0.1,0,0,0,0,0.0
204,Churlinov,5.0,5.0,0.0,-315,-315,Churlinov,50,0,45,360,0.0,Churlinov,50,0,45,360,0.0,0,0,0,0,0.0
205,Cullen,5.0,5.0,0.0,1971,1971,Cullen,50,0,2891,920,0.1,Cullen,50,0,2891,920,0.1,0,0,0,0,0.0
206,Edwards,5.0,5.0,0.0,-1148,-1148,Edwards,50,0,261,1409,0.1,Edwards,50,0,261,1409,0.1,0,0,0,0,0.0
207,Hannibal,5.0,5.0,0.0,-951,-951,Hannibal,50,0,843,1794,0.1,Hannibal,50,0,843,1794,0.1,0,0,0,0,0.0
208,Koleosho,5.0,5.0,0.0,-508,-508,Koleosho,50,0,65,573,0.0,Koleosho,50,0,65,573,0.0,0,0,0,0,0.0
209,Laurent,5.0,5.0,0.0,-158,-158,Laurent,50,0,194,352,0.0,Laurent,50,0,194,352,0.0,0,0,0,0,0.0
210,Tchaouna,5.0,5.0,0.0,-295,-295,Tchaouna,50,0,46,341,0.0,Tchaouna,50,0,46,341,0.0,0,0,0,0,0.0
211,A.Ramsey,4.5,4.5,0.0,-61989,-61989,A.Ramsey,45,0,31925,93914,9.0,A.Ramsey,45,0,31925,93914,9.0,0,0,0,0,0.0
212,Adewumi,4.5,4.5,0.0,-980,-980,Adewumi,45,0,0,980,0.0,Adewumi,45,0,0,980,0.0,0,0,0,0,0.0
213,Banel,4.5,4.5,0.0,-263,-263,Banel,45,0,227,490,0.0,Banel,45,0,227,490,0.0,0,0,0,0,0.0
214,Trésor,4.5,4.5,0.0,-544,-544,Trésor,45,0,385,929,0.1,Trésor,45,0,385,929,0.1,0,0,0,0,0.0
215,Flemming,5.5,5.5,0.0,-1184,-1184,Flemming,55,0,1642,2826,0.2,Flemming,55,0,1642,2826,0.2,0,0,0,0,0.0
216,Amdouni,5.0,5.0,0.0,-1688,-1688,Amdouni,50,0,131,1819,0.0,Amdouni,50,0,131,1819,0.0,0,0,0,0,0.0
217,Foster,5.0,5.0,0.0,10780,10780,Foster,50,0,19588,8808,0.5,Foster,50,0,19588,8808,0.5,0,0,0,0,0.0
218,Barnes,4.5,4.5,0.0,-13276,-13276,Barnes,45,0,11093,24369,2.3,Barnes,45,0,11093,24369,2.3,0,0,0,0,0.0
219,Obafemi,4.5,4.5,0.0,-2257,-2257,Obafemi,45,0,2043,4300,0.4,Obafemi,45,0,2043,4300,0.4,0,0,0,0,0.0
470,Dúbravka,4.0,4.0,0.0,89390,89390,Dúbravka,40,0,128324,38934,34.6,Dúbravka,40,0,128324,38934,34.6,0,0,0,0,0.0
676,Ugochukwu,5.0,5.0,0.0,-312,-312,Ugochukwu,50,0,250,562,0.0,Ugochukwu,50,0,250,562,0.0,0,0,0,0,0.0
680,Broja,5.5,5.5,0.0,-1517,-1517,Broja,55,0,2261,3778,0.2,Broja,55,0,2261,3778,0.2,0,0,0,0,0.0
66,Neto,4.5,4.5,0.0,-5762,-5762,Neto,45,0,0,5762,0.2,Neto,45,0,0,5762,0.2,0,0,0,0,0.0
67,Petrović,4.5,4.5,0.0,29082,29082,Petrović,45,0,50977,21895,3.6,Petrović,45,0,50977,21895,3.6,0,0,0,0,0.0
68,Dennis,4.0,4.0,0.0,2591,2591,Dennis,40,0,7134,4543,1.1,Dennis,40,0,7134,4543,1.1,0,0,0,0,0.0
69,McKenna,4.0,4.0,0.0,-34,-34,McKenna,40,0,962,996,0.2,McKenna,40,0,962,996,0.2,0,0,0,0,0.0
70,Paulsen,4.0,4.0,0.0,-26,-26,Paulsen,40,0,693,719,0.1,Paulsen,40,0,693,719,0.1,0,0,0,0,0.0
71,Zabarnyi,5.0,5.0,0.0,-4674,-4674,Zabarnyi,50,0,0,4674,0.1,Zabarnyi,50,0,0,4674,0.1,0,0,0,0,0.0
72,Senesi,4.5,4.5,0.0,33000,33000,Senesi,45,0,42452,9452,1.3,Senesi,45,0,42452,9452,1.3,0,0,0,0,0.0
73,Smith,4.5,4.5,0.0,6691,6691,Smith,45,0,9649,2958,0.4,Smith,45,0,9649,2958,0.4,0,0,0,0,0.0
74,Truffert,4.5,4.5,0.0,23960,23960,Truffert,45,0,32847,8887,1.0,Truffert,45,0,32847,8887,1.0,0,0,0,0,0.0
75,Akinmboni,4.0,4.0,0.0,-757,-757,Akinmboni,40,0,1928,2685,0.3,Akinmboni,40,0,1928,2685,0.3,0,0,0,0,0.0
76,Bevan,4.0,4.0,0.0,-949,-949,Bevan,40,0,636,1585,0.2,Bevan,40,0,636,1585,0.2,0,0,0,0,0.0
77,Hill,4.0,4.0,0.0,2890,2890,Hill,40,0,9781,6891,0.8,Hill,40,0,9781,6891,0.8,0,0,0,0,0.0
78,J.Araujo,4.0,4.0,0.0,-4576,-4576,J.Araujo,40,0,6398,10974,1.3,J.Araujo,40,0,6398,10974,1.3,0,0,0,0,0.0
79,Mepham,4.0,4.0,0.0,-1108,-1108,Mepham,40,0,579,1687,0.2,Mepham,40,0,579,1687,0.2,0,0,0,0,0.0
80,Soler,4.0,4.0,0.0,-1186,-1186,Soler,40,0,1202,2388,0.3,Soler,40,0,1202,2388,0.3,0,0,0,0,0.0
81,Kluivert,7.0,7.0,0.0,-33697,-33697,Kluivert,70,0,287,33984,0.6,Kluivert,70,0,287,33984,0.6,0,0,0,0,0.0
82,Semenyo,7.1,7.1,0.0,725056,725056,Semenyo,71,1,767392,42336,14.9,Semenyo,71,1,767392,42336,14.9,0,0,0,0,0.0
84,Tavernier,5.5,5.5,0.0,12914,12914,Tavernier,55,0,20319,7405,0.6,Tavernier,55,0,20319,7405,0.6,0,0,0,0,0.0
85,Adams,5.0,5.0,0.0,2643,2643,Adams,50,0,6533,3890,0.3,Adams,50,0,6533,3890,0.3,0,0,0,0,0.0
86,Brooks,5.0,5.0,0.0,7195,7195,Brooks,50,0,10353,3158,0.2,Brooks,50,0,10353,3158,0.2,0,0,0,0,0.0
87,Christie,5.0,5.0,0.0,-2199,-2199,Christie,50,0,71,2270,0.1,Christie,50,0,71,2270,0.1,0,0,0,0,0.0
88,Cook,5.0,5.0,0.0,-256,-256,Cook,50,0,42,298,0.0,Cook,50,0,42,298,0.0,0,0,0,0,0.0
89,Philip,5.0,5.0,0.0,-924,-924,Philip,50,0,380,1304,0.1,Philip,50,0,380,1304,0.1,0,0,0,0,0.0
90,Scott,5.0,5.0,0.0,17,17,Scott,50,0,1162,1145,0.1,Scott,50,0,1162,1145,0.1,0,0,0,0,0.0
91,Sinisterra,5.0,5.0,0.0,-1060,-1060,Sinisterra,50,0,99,1159,0.0,Sinisterra,50,0,99,1159,0.0,0,0,0,0,0.0
92,Faivre,4.5,4.5,0.0,-1053,-1053,Faivre,45,0,1562,2615,0.2,Faivre,45,0,1562,2615,0.2,0,0,0,0,0.0
93,H.Traorè,4.5,4.5,0.0,52888,52888,H.Traorè,45,0,70053,17165,1.2,H.Traorè,45,0,70053,17165,1.2,0,0,0,0,0.0
94,Sadi,4.5,4.5,0.0,-328,-328,Sadi,45,0,435,763,0.1,Sadi,45,0,435,763,0.1,0,0,0,0,0.0
95,Silcott-Duberry,4.5,4.5,0.0,-720,-720,Silcott-Duberry,45,0,323,1043,0.1,Silcott-Duberry,45,0,323,1043,0.1,0,0,0,0,0.0
96,Winterburn,4.5,4.5,0.0,697,697,Winterburn,45,0,1819,1122,0.1,Winterburn,45,0,1819,1122,0.1,0,0,0,0,0.0
97,Evanilson,7.0,7.0,0.0,38590,38590,Evanilson,70,0,70440,31850,2.5,Evanilson,70,0,70440,31850,2.5,0,0,0,0,0.0
98,Enes Ünal,5.5,5.5,0.0,-165,-165,Enes Ünal,55,0,128,293,0.0,Enes Ünal,55,0,128,293,0.0,0,0,0,0,0.0
99,Adu-Adjei,4.5,4.5,0.0,-1055,-1055,Adu-Adjei,45,0,3026,4081,0.3,Adu-Adjei,45,0,3026,4081,0.3,0,0,0,0,0.0
100,Kroupi.Jr,4.5,4.5,0.0,24693,24693,Kroupi.Jr,45,0,42208,17515,1.3,Kroupi.Jr,45,0,42208,17515,1.3,0,0,0,0,0.0
391,Gannon-Doak,5.0,5.0,0.0,919,919,Gannon-Doak,50,0,1855,936,0.1,Gannon-Doak,50,0,1855,936,0.1,0,0,0,0,0.0
685,Diakité,4.5,4.5,0.0,4330,4330,Diakité,45,0,6100,1770,0.2,Diakité,45,0,6100,1770,0.2,0,0,0,0,0.0
687,Rees-Dottin,4.5,4.5,0.0,2883,2883,Rees-Dottin,45,0,4345,1462,0.1,Rees-Dottin,45,0,4345,1462,0.1,0,0,0,0,0.0
697,Adli,5.5,5.5,0.0,269,269,Adli,55,0,318,49,0.0,Adli,55,0,318,49,0.0,0,0,0,0,0.0
83,O.Dango,6.0,6.0,0.0,-1801,-1801,O.Dango,60,0,799,2600,0.1,O.Dango,60,0,799,2600,0.1,0,0,0,0,0.0
101,Kelleher,4.5,4.5,0.0,-47192,-47192,Kelleher,45,0,24082,71274,10.3,Kelleher,45,0,24082,71274,10.3,0,0,0,0,0.0
102,Balcombe,4.0,4.0,0.0,213,213,Balcombe,40,0,1809,1596,0.3,Balcombe,40,0,1809,1596,0.3,0,0,0,0,0.0
103,Cox,4.0,4.0,0.0,-165,-165,Cox,40,0,640,805,0.2,Cox,40,0,640,805,0.2,0,0,0,0,0.0
104,Eyestone,4.0,4.0,0.0,-228,-228,Eyestone,40,0,249,477,0.1,Eyestone,40,0,249,477,0.1,0,0,0,0,0.0
105,Valdimarsson,4.0,4.0,0.0,-3035,-3035,Valdimarsson,40,0,1589,4624,1.0,Valdimarsson,40,0,1589,4624,1.0,0,0,0,0,0.0
106,Collins,5.0,5.0,0.0,-13722,-13722,Collins,50,0,4349,18071,1.6,Collins,50,0,4349,18071,1.6,0,0,0,0,0.0
107,Lewis-Potter,5.0,5.0,0.0,-1354,-1354,Lewis-Potter,50,0,2543,3897,0.4,Lewis-Potter,50,0,2543,3897,0.4,0,0,0,0,0.0
108,Ajer,4.5,4.5,0.0,-1307,-1307,Ajer,45,0,885,2192,0.2,Ajer,45,0,885,2192,0.2,0,0,0,0,0.0
109,Henry,4.5,4.5,0.0,-253,-253,Henry,45,0,1111,1364,0.2,Henry,45,0,1111,1364,0.2,0,0,0,0,0.0
110,Kayode,4.5,4.5,0.0,-523,-523,Kayode,45,0,1055,1578,0.2,Kayode,45,0,1055,1578,0.2,0,0,0,0,0.0
111,Pinnock,4.5,4.5,0.0,-3477,-3477,Pinnock,45,0,591,4068,0.2,Pinnock,45,0,591,4068,0.2,0,0,0,0,0.0
112,Roerslev,4.5,4.5,0.0,-426,-426,Roerslev,45,0,204,630,0.0,Roerslev,45,0,204,630,0.0,0,0,0,0,0.0
113,Van den Berg,4.5,4.5,0.0,1308,1308,Van den Berg,45,0,4441,3133,0.4,Van den Berg,45,0,4441,3133,0.4,0,0,0,0,0.0
114,Arthur,4.0,4.0,0.0,-1052,-1052,Arthur,40,0,1505,2557,0.3,Arthur,40,0,1505,2557,0.3,0,0,0,0,0.0
115,Fredrick,4.0,4.0,0.0,-869,-869,Fredrick,40,0,542,1411,0.2,Fredrick,40,0,542,1411,0.2,0,0,0,0,0.0
116,Hickey,4.0,4.0,0.0,-1875,-1875,Hickey,40,0,1547,3422,0.5,Hickey,40,0,1547,3422,0.5,0,0,0,0,0.0
117,Ji-soo,4.0,4.0,0.0,-1018,-1018,Ji-soo,40,0,391,1409,0.2,Ji-soo,40,0,391,1409,0.2,0,0,0,0,0.0
118,Meghoma,4.0,4.0,0.0,-2024,-2024,Meghoma,40,0,279,2303,0.1,Meghoma,40,0,279,2303,0.1,0,0,0,0,0.0
120,Schade,7.0,7.0,0.0,-3156,-3156,Schade,70,0,1555,4711,0.3,Schade,70,0,1555,4711,0.3,0,0,0,0,0.0
121,Damsgaard,5.9,5.9,0.0,-20706,-20706,Damsgaard,59,-1,1796,22502,0.9,Damsgaard,59,-1,1796,22502,0.9,0,0,0,0,0.0
122,Milambo,5.5,5.5,0.0,-604,-604,Milambo,55,0,383,987,0.1,Milambo,55,0,383,987,0.1,0,0,0,0,0.0
123,Carvalho,5.0,5.0,0.0,-1359,-1359,Carvalho,50,0,2620,3979,0.3,Carvalho,50,0,2620,3979,0.3,0,0,0,0,0.0
124,Henderson,5.0,5.0,0.0,-2666,-2666,Henderson,50,0,1459,4125,0.3,Henderson,50,0,1459,4125,0.3,0,0,0,0,0.0
125,Janelt,5.0,5.0,0.0,-517,-517,Janelt,50,0,29,546,0.0,Janelt,50,0,29,546,0.0,0,0,0,0,0.0
126,Jensen,5.0,5.0,0.0,-532,-532,Jensen,50,0,494,1026,0.1,Jensen,50,0,494,1026,0.1,0,0,0,0,0.0
127,Nunes,5.0,5.0,0.0,-294,-294,Nunes,50,0,27,321,0.0,Nunes,50,0,27,321,0.0,0,0,0,0,0.0
128,Onyeka,5.0,5.0,0.0,728,728,Onyeka,50,0,1400,672,0.1,Onyeka,50,0,1400,672,0.1,0,0,0,0,0.0
129,Yarmoliuk,5.0,5.0,0.0,-305,-305,Yarmoliuk,50,0,201,506,0.0,Yarmoliuk,50,0,201,506,0.0,0,0,0,0,0.0
130,Donovan,4.5,4.5,0.0,-440,-440,Donovan,45,0,973,1413,0.1,Donovan,45,0,973,1413,0.1,0,0,0,0,0.0
131,Konak,4.5,4.5,0.0,-1447,-1447,Konak,45,0,470,1917,0.2,Konak,45,0,470,1917,0.2,0,0,0,0,0.0
132,Maghoma,4.5,4.5,0.0,-667,-667,Maghoma,45,0,61,728,0.0,Maghoma,45,0,61,728,0.0,0,0,0,0,0.0
133,Peart-Harris,4.5,4.5,0.0,-189,-189,Peart-Harris,45,0,326,515,0.0,Peart-Harris,45,0,326,515,0.0,0,0,0,0,0.0
134,Trevitt,4.5,4.5,0.0,-291,-291,Trevitt,45,0,0,291,0.0,Trevitt,45,0,0,291,0.0,0,0,0,0,0.0
135,Wissa,7.5,7.5,0.0,-87563,-87563,Wissa,75,0,4367,91930,1.7,Wissa,75,0,4367,91930,1.7,0,0,0,0,0.0
136,Thiago,6.0,6.0,0.0,13666,13666,Thiago,60,0,24990,11324,1.1,Thiago,60,0,24990,11324,1.1,0,0,0,0,0.0
137,Morgan,4.5,4.5,0.0,-1840,-1840,Morgan,45,0,3843,5683,0.5,Morgan,45,0,3843,5683,0.5,0,0,0,0,0.0
138,Steele,4.5,4.5,0.0,-4254,-4254,Steele,45,0,1232,5486,0.5,Steele,45,0,1232,5486,0.5,0,0,0,0,0.0
139,Verbruggen,4.5,4.5,0.0,-16184,-16184,Verbruggen,45,0,30190,46374,7.4,Verbruggen,45,0,30190,46374,7.4,0,0,0,0,0.0
140,McGill,4.0,4.0,0.0,-146,-146,McGill,40,0,1940,2086,0.4,McGill,40,0,1940,2086,0.4,0,0,0,0,0.0
141,Rushworth,4.0,4.0,0.0,-67,-67,Rushworth,40,0,0,67,0.0,Rushworth,40,0,0,67,0.0,0,0,0,0,0.0
142,Scherpen,4.0,4.0,0.0,-59,-59,Scherpen,40,0,0,59,0.0,Scherpen,40,0,0,59,0.0,0,0,0,0,0.0
143,Boscagli,4.5,4.5,0.0,-1267,-1267,Boscagli,45,0,661,1928,0.1,Boscagli,45,0,661,1928,0.1,0,0,0,0,0.0
144,Coppola,4.5,4.5,0.0,-871,-871,Coppola,45,0,213,1084,0.1,Coppola,45,0,213,1084,0.1,0,0,0,0,0.0
145,De Cuyper,4.5,4.5,0.0,-10406,-10406,De Cuyper,45,0,27473,37879,6.0,De Cuyper,45,0,27473,37879,6.0,0,0,0,0,0.0
146,Dunk,4.5,4.5,0.0,3375,3375,Dunk,45,0,11941,8566,1.3,Dunk,45,0,11941,8566,1.3,0,0,0,0,0.0
147,Estupiñan,4.5,4.5,0.0,-959,-959,Estupiñan,45,0,0,959,0.0,Estupiñan,45,0,0,959,0.0,0,0,0,0,0.0
148,F.Kadıoğlu,4.5,4.5,0.0,-2293,-2293,F.Kadıoğlu,45,0,899,3192,0.2,F.Kadıoğlu,45,0,899,3192,0.2,0,0,0,0,0.0
149,Igor,4.5,4.5,0.0,-218,-218,Igor,45,0,308,526,0.1,Igor,45,0,308,526,0.1,0,0,0,0,0.0
150,Lamptey,4.5,4.5,0.0,-4127,-4127,Lamptey,45,0,1433,5560,0.4,Lamptey,45,0,1433,5560,0.4,0,0,0,0,0.0
151,Van Hecke,4.5,4.5,0.0,-2853,-2853,Van Hecke,45,0,5744,8597,1.2,Van Hecke,45,0,5744,8597,1.2,0,0,0,0,0.0
152,Veltman,4.5,4.5,0.0,-3309,-3309,Veltman,45,0,451,3760,0.2,Veltman,45,0,451,3760,0.2,0,0,0,0,0.0
153,Webster,4.5,4.5,0.0,-327,-327,Webster,45,0,74,401,0.0,Webster,45,0,74,401,0.0,0,0,0,0,0.0
154,Cashin,4.0,4.0,0.0,-259,-259,Cashin,40,0,0,259,0.0,Cashin,40,0,0,259,0.0,0,0,0,0,0.0
155,Slater,4.0,4.0,0.0,-971,-971,Slater,40,0,813,1784,0.2,Slater,40,0,813,1784,0.2,0,0,0,0,0.0
156,Tasker,4.0,4.0,0.0,-891,-891,Tasker,40,0,573,1464,0.2,Tasker,40,0,573,1464,0.2,0,0,0,0,0.0
157,Mitoma,6.5,6.5,0.0,-80678,-80678,Mitoma,65,0,18702,99380,6.3,Mitoma,65,0,18702,99380,6.3,0,0,0,0,0.0
158,Georginio,6.0,6.0,0.0,-2873,-2873,Georginio,60,0,17478,20351,1.4,Georginio,60,0,17478,20351,1.4,0,0,0,0,0.0
159,March,5.9,5.9,0.0,-896,-896,March,59,-1,45,941,0.0,March,59,-1,45,941,0.0,0,0,0,0,0.0
160,Minteh,6.0,6.0,0.0,-16619,-16619,Minteh,60,0,4281,20900,1.0,Minteh,60,0,4281,20900,1.0,0,0,0,0,0.0
161,Enciso,5.5,5.5,0.0,-1303,-1303,Enciso,55,0,45,1348,0.0,Enciso,55,0,45,1348,0.0,0,0,0,0,0.0
162,Gruda,5.5,5.5,0.0,-613,-613,Gruda,55,0,218,831,0.0,Gruda,55,0,218,831,0.0,0,0,0,0,0.0
163,Hinshelwood,5.4,5.4,0.0,-2252,-2252,Hinshelwood,54,-1,156,2408,0.1,Hinshelwood,54,-1,156,2408,0.1,0,0,0,0,0.0
164,O'Riley,5.5,5.5,0.0,79896,79896,O'Riley,55,0,99272,19376,1.7,O'Riley,55,0,99272,19376,1.7,0,0,0,0,0.0
165,Sima,5.5,5.5,0.0,-334,-334,Sima,55,0,117,451,0.0,Sima,55,0,117,451,0.0,0,0,0,0,0.0
166,Ayari,5.0,5.0,0.0,-1092,-1092,Ayari,50,0,1341,2433,0.2,Ayari,50,0,1341,2433,0.2,0,0,0,0,0.0
167,Baleba,5.0,5.0,0.0,-21720,-21720,Baleba,50,0,27504,49224,4.6,Baleba,50,0,27504,49224,4.6,0,0,0,0,0.0
168,Buonanotte,5.0,5.0,0.0,-3401,-3401,Buonanotte,50,0,211,3612,0.2,Buonanotte,50,0,211,3612,0.2,0,0,0,0,0.0
169,Gomez,5.0,5.0,0.0,-657,-657,Gomez,50,0,227,884,0.1,Gomez,50,0,227,884,0.1,0,0,0,0,0.0
170,Milner,5.0,5.0,0.0,-873,-873,Milner,50,0,648,1521,0.1,Milner,50,0,648,1521,0.1,0,0,0,0,0.0
171,Sarmiento,5.0,5.0,0.0,-507,-507,Sarmiento,50,0,55,562,0.0,Sarmiento,50,0,55,562,0.0,0,0,0,0,0.0
172,Watson,5.0,5.0,0.0,-222,-222,Watson,50,0,123,345,0.0,Watson,50,0,123,345,0.0,0,0,0,0,0.0
173,Wieffer,5.0,5.0,0.0,356,356,Wieffer,50,0,1263,907,0.1,Wieffer,50,0,1263,907,0.1,0,0,0,0,0.0
174,Yalcouye,5.0,5.0,0.0,-609,-609,Yalcouye,50,0,0,609,0.0,Yalcouye,50,0,0,609,0.0,0,0,0,0,0.0
175,Knight,4.5,4.5,0.0,-426,-426,Knight,45,0,672,1098,0.1,Knight,45,0,672,1098,0.1,0,0,0,0,0.0
176,Mazilu,4.5,4.5,0.0,-275,-275,Mazilu,45,0,252,527,0.0,Mazilu,45,0,252,527,0.0,0,0,0,0,0.0
177,Moran,4.5,4.5,0.0,-288,-288,Moran,45,0,473,761,0.1,Moran,45,0,473,761,0.1,0,0,0,0,0.0
178,Welbeck,6.5,6.5,0.0,-75937,-75937,Welbeck,65,0,13544,89481,3.7,Welbeck,65,0,13544,89481,3.7,0,0,0,0,0.0
179,Ferguson,5.5,5.5,0.0,-762,-762,Ferguson,55,0,0,762,0.0,Ferguson,55,0,0,762,0.0,0,0,0,0,0.0
180,Tzimas,5.5,5.5,0.0,-1668,-1668,Tzimas,55,0,1236,2904,0.1,Tzimas,55,0,1236,2904,0.1,0,0,0,0,0.0
181,Kostoulas,5.0,5.0,0.0,-4005,-4005,Kostoulas,50,0,3258,7263,0.4,Kostoulas,50,0,3258,7263,0.4,0,0,0,0,0.0
220,Sánchez,5.0,5.0,0.0,56855,56855,Sánchez,50,0,134775,77920,25.4,Sánchez,50,0,134775,77920,25.4,0,0,0,0,0.0
221,Jörgensen,4.5,4.5,0.0,-1829,-1829,Jörgensen,45,0,719,2548,0.2,Jörgensen,45,0,719,2548,0.2,0,0,0,0,0.0
222,Penders,4.0,4.0,0.0,-110,-110,Penders,40,0,0,110,0.0,Penders,40,0,0,110,0.0,0,0,0,0,0.0
223,Slonina,4.0,4.0,0.0,-236,-236,Slonina,40,0,620,856,0.1,Slonina,40,0,620,856,0.1,0,0,0,0,0.0
224,Cucurella,6.0,6.0,0.0,203284,203284,Cucurella,60,0,279875,76591,21.7,Cucurella,60,0,279875,76591,21.7,0,0,0,0,0.0
225,James,5.5,5.5,0.0,29453,29453,James,55,0,62738,33285,5.9,James,55,0,62738,33285,5.9,0,0,0,0,0.0
226,Chalobah,5.0,5.0,0.0,19209,19209,Chalobah,50,0,32312,13103,1.4,Chalobah,50,0,32312,13103,1.4,0,0,0,0,0.0
227,Colwill,4.9,4.9,0.0,-14375,-14375,Colwill,49,-1,160,14535,0.3,Colwill,49,-1,160,14535,0.3,0,0,0,0,0.0
228,Gusto,5.0,5.0,0.0,-17544,-17544,Gusto,50,0,9629,27173,1.6,Gusto,50,0,9629,27173,1.6,0,0,0,0,0.0
229,B.Badiashile,4.5,4.5,0.0,-602,-602,B.Badiashile,45,0,46,648,0.0,B.Badiashile,45,0,46,648,0.0,0,0,0,0,0.0
230,Fofana,4.5,4.5,0.0,-3258,-3258,Fofana,45,0,1102,4360,0.2,Fofana,45,0,1102,4360,0.2,0,0,0,0,0.0
231,M.Sarr,4.5,4.5,0.0,-910,-910,M.Sarr,45,0,0,910,0.0,M.Sarr,45,0,0,910,0.0,0,0,0,0,0.0
232,Tosin,4.5,4.5,0.0,-15845,-15845,Tosin,45,0,7194,23039,1.1,Tosin,45,0,7194,23039,1.1,0,0,0,0,0.0
233,Acheampong,4.0,4.0,0.0,154569,154569,Acheampong,40,0,178272,23703,2.4,Acheampong,40,0,178272,23703,2.4,0,0,0,0,0.0
234,Anselmino,4.0,4.0,0.0,-974,-974,Anselmino,40,0,505,1479,0.1,Anselmino,40,0,505,1479,0.1,0,0,0,0,0.0
235,Palmer,10.5,10.5,0.0,-220747,-220747,Palmer,105,0,96680,317427,59.1,Palmer,105,0,96680,317427,59.1,0,0,0,0,0.0
236,Neto,7.0,7.0,0.0,-25611,-25611,Neto,70,0,20662,46273,3.6,Neto,70,0,20662,46273,3.6,0,0,0,0,0.0
237,Enzo,6.5,6.5,0.0,-34642,-34642,Enzo,65,0,15057,49699,3.4,Enzo,65,0,15057,49699,3.4,0,0,0,0,0.0
238,Estêvão,6.5,6.5,0.0,-22702,-22702,Estêvão,65,0,13927,36629,1.5,Estêvão,65,0,13927,36629,1.5,0,0,0,0,0.0
239,Gittens,6.5,6.5,0.0,-4160,-4160,Gittens,65,0,2263,6423,0.3,Gittens,65,0,2263,6423,0.3,0,0,0,0,0.0
240,Nkunku,6.0,6.0,0.0,-3822,-3822,Nkunku,60,0,1608,5430,0.2,Nkunku,60,0,1608,5430,0.2,0,0,0,0,0.0
241,Caicedo,5.5,5.5,0.0,-15195,-15195,Caicedo,55,0,42791,57986,5.5,Caicedo,55,0,42791,57986,5.5,0,0,0,0,0.0
243,George,5.0,5.0,0.0,-512,-512,George,50,0,388,900,0.1,George,50,0,388,900,0.1,0,0,0,0,0.0
244,Lavia,5.0,5.0,0.0,-872,-872,Lavia,50,0,32,904,0.0,Lavia,50,0,32,904,0.0,0,0,0,0,0.0
245,Mudryk,5.0,5.0,0.0,-93,-93,Mudryk,50,0,99,192,0.0,Mudryk,50,0,99,192,0.0,0,0,0,0,0.0
246,Andrey Santos,4.5,4.5,0.0,1212,1212,Andrey Santos,45,0,6303,5091,0.3,Andrey Santos,45,0,6303,5091,0.3,0,0,0,0,0.0
247,D.Essugo,4.5,4.5,0.0,-298,-298,D.Essugo,45,0,489,787,0.1,D.Essugo,45,0,489,787,0.1,0,0,0,0,0.0
248,Paez,4.5,4.5,0.0,-401,-401,Paez,45,0,0,401,0.0,Paez,45,0,0,401,0.0,0,0,0,0,0.0
249,João Pedro,7.5,7.5,0.0,-239009,-239009,João Pedro,75,0,143533,382542,51.9,João Pedro,75,0,143533,382542,51.9,0,0,0,0,0.0
250,Delap,6.5,6.5,0.0,-49460,-49460,Delap,65,0,15804,65264,3.6,Delap,65,0,15804,65264,3.6,0,0,0,0,0.0
251,N.Jackson,6.5,6.5,0.0,1245,1245,N.Jackson,65,0,2692,1447,0.2,N.Jackson,65,0,2692,1447,0.2,0,0,0,0,0.0
672,Hato,5.0,5.0,0.0,-4251,-4251,Hato,50,0,1924,6175,0.3,Hato,50,0,1924,6175,0.3,0,0,0,0,0.0
253,Henderson,5.0,5.0,0.0,7414,7414,Henderson,50,0,35676,28262,7.3,Henderson,50,0,35676,28262,7.3,0,0,0,0,0.0
254,Benitez,4.0,4.0,0.0,-302,-302,Benitez,40,0,1828,2130,0.4,Benitez,40,0,1828,2130,0.4,0,0,0,0,0.0
255,Matthews,4.0,4.0,0.0,-203,-203,Matthews,40,0,373,576,0.1,Matthews,40,0,373,576,0.1,0,0,0,0,0.0
256,Muñoz,5.5,5.5,0.0,21706,21706,Muñoz,55,0,66940,45234,8.7,Muñoz,55,0,66940,45234,8.7,0,0,0,0,0.0
257,Lacroix,5.0,5.0,0.0,17554,17554,Lacroix,50,0,28737,11183,1.4,Lacroix,50,0,28737,11183,1.4,0,0,0,0,0.0
258,Mitchell,5.0,5.0,0.0,31224,31224,Mitchell,50,0,42792,11568,1.7,Mitchell,50,0,42792,11568,1.7,0,0,0,0,0.0
259,Sosa,5.0,5.0,0.0,-1020,-1020,Sosa,50,0,796,1816,0.1,Sosa,50,0,796,1816,0.1,0,0,0,0,0.0
260,Guéhi,4.5,4.5,0.0,76054,76054,Guéhi,45,0,126063,50009,13.2,Guéhi,45,0,126063,50009,13.2,0,0,0,0,0.0
261,Richards,4.5,4.5,0.0,13263,13263,Richards,45,0,23882,10619,1.6,Richards,45,0,23882,10619,1.6,0,0,0,0,0.0
262,Chadi Riad,4.0,4.0,0.0,-47,-47,Chadi Riad,40,0,69,116,0.0,Chadi Riad,40,0,69,116,0.0,0,0,0,0,0.0
263,Clyne,4.0,4.0,0.0,-3301,-3301,Clyne,40,0,2044,5345,0.7,Clyne,40,0,2044,5345,0.7,0,0,0,0,0.0
264,Holding,4.0,4.0,0.0,-1345,-1345,Holding,40,0,0,1345,0.0,Holding,40,0,0,1345,0.0,0,0,0,0,0.0
265,Kporha,4.0,4.0,0.0,-516,-516,Kporha,40,0,62,578,0.0,Kporha,40,0,62,578,0.0,0,0,0,0,0.0
266,Eze,7.5,7.5,0.0,-46164,-46164,Eze,75,0,90565,136729,10.5,Eze,75,0,90565,136729,10.5,0,0,0,0,0.0
267,Sarr,6.5,6.5,0.0,-33641,-33641,Sarr,65,0,23708,57349,4.6,Sarr,65,0,23708,57349,4.6,0,0,0,0,0.0
268,Doucouré,5.0,5.0,0.0,-66,-66,Doucouré,50,0,28,94,0.0,Doucouré,50,0,28,94,0.0,0,0,0,0,0.0
269,Esse,5.0,5.0,0.0,-2349,-2349,Esse,50,0,1652,4001,0.2,Esse,50,0,1652,4001,0.2,0,0,0,0,0.0
270,Hughes,5.0,5.0,0.0,-499,-499,Hughes,50,0,762,1261,0.1,Hughes,50,0,762,1261,0.1,0,0,0,0,0.0
271,Kamada,5.0,5.0,0.0,-517,-517,Kamada,50,0,35,552,0.0,Kamada,50,0,35,552,0.0,0,0,0,0,0.0
272,Lerma,5.0,5.0,0.0,-597,-597,Lerma,50,0,191,788,0.1,Lerma,50,0,191,788,0.1,0,0,0,0,0.0
273,Wharton,5.0,5.0,0.0,500,500,Wharton,50,0,6640,6140,0.6,Wharton,50,0,6640,6140,0.6,0,0,0,0,0.0
274,Agbinone,4.5,4.5,0.0,-318,-318,Agbinone,45,0,396,714,0.1,Agbinone,45,0,396,714,0.1,0,0,0,0,0.0
275,Ahamada,4.5,4.5,0.0,-214,-214,Ahamada,45,0,315,529,0.0,Ahamada,45,0,315,529,0.0,0,0,0,0,0.0
276,Devenny,4.5,4.5,0.0,-10149,-10149,Devenny,45,0,6288,16437,1.7,Devenny,45,0,6288,16437,1.7,0,0,0,0,0.0
277,Ebiowei,4.5,4.5,0.0,-280,-280,Ebiowei,45,0,0,280,0.0,Ebiowei,45,0,0,280,0.0,0,0,0,0,0.0
278,J.Rak-Sakyi,4.5,4.5,0.0,-390,-390,J.Rak-Sakyi,45,0,468,858,0.1,J.Rak-Sakyi,45,0,468,858,0.1,0,0,0,0,0.0
279,M.França,4.5,4.5,0.0,-389,-389,M.França,45,0,48,437,0.0,M.França,45,0,48,437,0.0,0,0,0,0,0.0
280,Ozoh,4.5,4.5,0.0,-67,-67,Ozoh,45,0,0,67,0.0,Ozoh,45,0,0,67,0.0,0,0,0,0,0.0
281,Rodney,4.5,4.5,0.0,-219,-219,Rodney,45,0,324,543,0.0,Rodney,45,0,324,543,0.0,0,0,0,0,0.0
282,Umeh,4.5,4.5,0.0,-180,-180,Umeh,45,0,189,369,0.0,Umeh,45,0,189,369,0.0,0,0,0,0,0.0
283,Mateta,7.5,7.5,0.0,-28851,-28851,Mateta,75,0,67942,96793,8.8,Mateta,75,0,67942,96793,8.8,0,0,0,0,0.0
284,Nketiah,5.5,5.5,0.0,-12855,-12855,Nketiah,55,0,347,13202,0.3,Nketiah,55,0,347,13202,0.3,0,0,0,0,0.0
285,Édouard,5.0,5.0,0.0,-7338,-7338,Édouard,50,0,5271,12609,0.9,Édouard,50,0,5271,12609,0.9,0,0,0,0,0.0
286,Marsh,4.5,4.5,0.0,-1327,-1327,Marsh,45,0,2005,3332,0.3,Marsh,45,0,2005,3332,0.3,0,0,0,0,0.0
690,Cardines,4.5,4.5,0.0,6521,6521,Cardines,45,0,8846,2325,0.2,Cardines,45,0,8846,2325,0.2,0,0,0,0,0.0
242,Dewsbury-Hall,5.0,5.0,0.0,-21568,-21568,Dewsbury-Hall,50,0,18846,40414,4.4,Dewsbury-Hall,50,0,18846,40414,4.4,0,0,0,0,0.0
287,Pickford,5.5,5.5,0.0,-55349,-55349,Pickford,55,0,20180,75529,10.6,Pickford,55,0,20180,75529,10.6,0,0,0,0,0.0
288,Travers,4.5,4.5,0.0,-862,-862,Travers,45,0,380,1242,0.2,Travers,45,0,380,1242,0.2,0,0,0,0,0.0
289,Tyrer,4.0,4.0,0.0,-281,-281,Tyrer,40,0,468,749,0.1,Tyrer,40,0,468,749,0.1,0,0,0,0,0.0
290,Branthwaite,5.4,5.4,0.0,-29151,-29151,Branthwaite,54,-1,201,29352,0.5,Branthwaite,54,-1,201,29352,0.5,0,0,0,0,0.0
291,Tarkowski,5.5,5.5,0.0,-15467,-15467,Tarkowski,55,0,26920,42387,6.8,Tarkowski,55,0,26920,42387,6.8,0,0,0,0,0.0
292,Mykolenko,5.0,5.0,0.0,-13875,-13875,Mykolenko,50,0,698,14573,0.8,Mykolenko,50,0,698,14573,0.8,0,0,0,0,0.0
293,O'Brien,5.0,5.0,0.0,-2037,-2037,O'Brien,50,0,3192,5229,0.6,O'Brien,50,0,3192,5229,0.6,0,0,0,0,0.0
294,Coleman,4.5,4.5,0.0,-1091,-1091,Coleman,45,0,820,1911,0.2,Coleman,45,0,820,1911,0.2,0,0,0,0,0.0
295,Keane,4.5,4.5,0.0,-335,-335,Keane,45,0,2900,3235,0.4,Keane,45,0,2900,3235,0.4,0,0,0,0,0.0
296,Patterson,4.5,4.5,0.0,-512,-512,Patterson,45,0,57,569,0.0,Patterson,45,0,57,569,0.0,0,0,0,0,0.0
297,Dixon,4.0,4.0,0.0,-1056,-1056,Dixon,40,0,973,2029,0.2,Dixon,40,0,973,2029,0.2,0,0,0,0,0.0
298,Welch,4.0,4.0,0.0,-964,-964,Welch,40,0,435,1399,0.2,Welch,40,0,435,1399,0.2,0,0,0,0,0.0
299,Ndiaye,6.5,6.5,0.0,-144797,-144797,Ndiaye,65,0,22650,167447,9.9,Ndiaye,65,0,22650,167447,9.9,0,0,0,0,0.0
300,McNeil,5.9,5.9,0.0,-8503,-8503,McNeil,59,-1,960,9463,0.3,McNeil,59,-1,960,9463,0.3,0,0,0,0,0.0
301,Alcaraz,5.5,5.5,0.0,-1648,-1648,Alcaraz,55,0,740,2388,0.2,Alcaraz,55,0,740,2388,0.2,0,0,0,0,0.0
302,Gana,5.5,5.5,0.0,-1188,-1188,Gana,55,0,406,1594,0.1,Gana,55,0,406,1594,0.1,0,0,0,0,0.0
303,Garner,5.0,5.0,0.0,-797,-797,Garner,50,0,401,1198,0.1,Garner,50,0,401,1198,0.1,0,0,0,0,0.0
304,Iroegbunam,5.0,5.0,0.0,-267,-267,Iroegbunam,50,0,98,365,0.0,Iroegbunam,50,0,98,365,0.0,0,0,0,0,0.0
305,Armstrong,4.5,4.5,0.0,-1646,-1646,Armstrong,45,0,570,2216,0.1,Armstrong,45,0,570,2216,0.1,0,0,0,0,0.0
306,Bates,4.5,4.5,0.0,-387,-387,Bates,45,0,738,1125,0.1,Bates,45,0,738,1125,0.1,0,0,0,0,0.0
307,Ebere,4.5,4.5,0.0,-199,-199,Ebere,45,0,298,497,0.0,Ebere,45,0,298,497,0.0,0,0,0,0,0.0
308,Heath,4.5,4.5,0.0,-252,-252,Heath,45,0,255,507,0.0,Heath,45,0,255,507,0.0,0,0,0,0,0.0
309,Metcalfe,4.5,4.5,0.0,-45,-45,Metcalfe,45,0,0,45,0.0,Metcalfe,45,0,0,45,0.0,0,0,0,0,0.0
310,Barry,6.0,6.0,0.0,-8830,-8830,Barry,60,0,4097,12927,0.7,Barry,60,0,4097,12927,0.7,0,0,0,0,0.0
311,Beto,5.5,5.5,0.0,-60491,-60491,Beto,55,0,37193,97684,7.8,Beto,55,0,37193,97684,7.8,0,0,0,0,0.0
312,Y.Chermiti,5.0,5.0,0.0,-1390,-1390,Y.Chermiti,50,0,1093,2483,0.2,Y.Chermiti,50,0,1093,2483,0.2,0,0,0,0,0.0
313,Sherif,4.5,4.5,0.0,-1151,-1151,Sherif,45,0,1699,2850,0.2,Sherif,45,0,1699,2850,0.2,0,0,0,0,0.0
419,Grealish,6.5,6.5,0.0,-35193,-35193,Grealish,65,0,14190,49383,3.2,Grealish,65,0,14190,49383,3.2,0,0,0,0,0.0
630,King,4.0,4.0,0.0,-3808,-3808,King,40,0,2864,6672,1.5,King,40,0,2864,6672,1.5,0,0,0,0,0.0
667,Aznou,4.5,4.5,0.0,-1289,-1289,Aznou,45,0,433,1722,0.1,Aznou,45,0,433,1722,0.1,0,0,0,0,0.0
314,Leno,5.0,5.0,0.0,-9423,-9423,Leno,50,0,3713,13136,1.6,Leno,50,0,3713,13136,1.6,0,0,0,0,0.0
315,Benda,4.0,4.0,0.0,-95,-95,Benda,40,0,0,95,0.0,Benda,40,0,0,95,0.0,0,0,0,0,0.0
316,Robinson,5.0,5.0,0.0,-29251,-29251,Robinson,50,0,404,29655,0.7,Robinson,50,0,404,29655,0.7,0,0,0,0,0.0
317,Andersen,4.5,4.5,0.0,-4537,-4537,Andersen,45,0,8405,12942,2.9,Andersen,45,0,8405,12942,2.9,0,0,0,0,0.0
318,Bassey,4.5,4.5,0.0,-2315,-2315,Bassey,45,0,2729,5044,0.5,Bassey,45,0,2729,5044,0.5,0,0,0,0,0.0
319,Castagne,4.5,4.5,0.0,-1128,-1128,Castagne,45,0,306,1434,0.1,Castagne,45,0,306,1434,0.1,0,0,0,0,0.0
320,Diop,4.5,4.5,0.0,-742,-742,Diop,45,0,272,1014,0.1,Diop,45,0,272,1014,0.1,0,0,0,0,0.0
321,J.Cuenca,4.5,4.5,0.0,-247,-247,J.Cuenca,45,0,167,414,0.0,J.Cuenca,45,0,167,414,0.0,0,0,0,0,0.0
322,Tete,4.5,4.5,0.0,-478,-478,Tete,45,0,1165,1643,0.2,Tete,45,0,1165,1643,0.2,0,0,0,0,0.0
323,Amissah,4.0,4.0,0.0,-1183,-1183,Amissah,40,0,513,1696,0.2,Amissah,40,0,513,1696,0.2,0,0,0,0,0.0
324,Iwobi,6.5,6.5,0.0,-21792,-21792,Iwobi,65,0,2805,24597,1.4,Iwobi,65,0,2805,24597,1.4,0,0,0,0,0.0
325,Smith Rowe,5.9,5.9,0.0,-18161,-18161,Smith Rowe,59,-1,2341,20502,0.8,Smith Rowe,59,-1,2341,20502,0.8,0,0,0,0,0.0
326,Adama,5.5,5.5,0.0,-4474,-4474,Adama,55,0,814,5288,0.3,Adama,55,0,814,5288,0.3,0,0,0,0,0.0
327,Andreas,5.4,5.4,0.0,-6822,-6822,Andreas,54,-1,905,7727,0.3,Andreas,54,-1,905,7727,0.3,0,0,0,0,0.0
328,Sessegnon,5.5,5.5,0.0,-759,-759,Sessegnon,55,0,43,802,0.0,Sessegnon,55,0,43,802,0.0,0,0,0,0,0.0
329,Wilson,5.5,5.5,0.0,-8509,-8509,Wilson,55,0,5744,14253,0.9,Wilson,55,0,5744,14253,0.9,0,0,0,0,0.0
330,Berge,5.0,5.0,0.0,-512,-512,Berge,50,0,210,722,0.1,Berge,50,0,210,722,0.1,0,0,0,0,0.0
331,Cairney,5.0,5.0,0.0,-465,-465,Cairney,50,0,74,539,0.0,Cairney,50,0,74,539,0.0,0,0,0,0,0.0
332,Lukić,5.0,5.0,0.0,-486,-486,Lukić,50,0,184,670,0.1,Lukić,50,0,184,670,0.1,0,0,0,0,0.0
333,Godo,4.5,4.5,0.0,-489,-489,Godo,45,0,440,929,0.1,Godo,45,0,440,929,0.1,0,0,0,0,0.0
334,Harris,4.5,4.5,0.0,-113,-113,Harris,45,0,0,113,0.0,Harris,45,0,0,113,0.0,0,0,0,0,0.0
335,King,4.5,4.5,0.0,21038,21038,King,45,0,38683,17645,1.2,King,45,0,38683,17645,1.2,0,0,0,0,0.0
336,Reed,4.5,4.5,0.0,-2037,-2037,Reed,45,0,1118,3155,0.3,Reed,45,0,1118,3155,0.3,0,0,0,0,0.0
337,Raúl,6.5,6.5,0.0,-26528,-26528,Raúl,65,0,6387,32915,1.9,Raúl,65,0,6387,32915,1.9,0,0,0,0,0.0
338,Muniz,5.5,5.5,0.0,30805,30805,Muniz,55,0,54352,23547,2.4,Muniz,55,0,54352,23547,2.4,0,0,0,0,0.0
664,Lecomte,4.0,4.0,0.0,-1671,-1671,Lecomte,40,0,1998,3669,0.8,Lecomte,40,0,1998,3669,0.8,0,0,0,0,0.0
339,Meslier,4.5,4.5,0.0,-7399,-7399,Meslier,45,0,1658,9057,0.7,Meslier,45,0,1658,9057,0.7,0,0,0,0,0.0
340,Cairns,4.0,4.0,0.0,-409,-409,Cairns,40,0,702,1111,0.2,Cairns,40,0,702,1111,0.2,0,0,0,0,0.0
341,Darlow,4.0,4.0,0.0,-9080,-9080,Darlow,40,0,6567,15647,3.0,Darlow,40,0,6567,15647,3.0,0,0,0,0,0.0
342,Bogle,4.5,4.5,0.0,-804,-804,Bogle,45,0,887,1691,0.2,Bogle,45,0,887,1691,0.2,0,0,0,0,0.0
343,Struijk,4.5,4.5,0.0,980,980,Struijk,45,0,4150,3170,0.4,Struijk,45,0,4150,3170,0.4,0,0,0,0,0.0
344,Bijol,4.0,4.0,0.0,631,631,Bijol,40,0,1667,1036,0.2,Bijol,40,0,1667,1036,0.2,0,0,0,0,0.0
345,Bornauw,4.0,4.0,0.0,-781,-781,Bornauw,40,0,88,869,0.1,Bornauw,40,0,88,869,0.1,0,0,0,0,0.0
346,Byram,4.0,4.0,0.0,-1681,-1681,Byram,40,0,565,2246,0.2,Byram,40,0,565,2246,0.2,0,0,0,0,0.0
347,Gudmundsson,4.0,4.0,0.0,51936,51936,Gudmundsson,40,0,73705,21769,3.5,Gudmundsson,40,0,73705,21769,3.5,0,0,0,0,0.0
348,Rodon,4.0,4.0,0.0,5466,5466,Rodon,40,0,17257,11791,2.3,Rodon,40,0,17257,11791,2.3,0,0,0,0,0.0
349,Schmidt,4.0,4.0,0.0,-1362,-1362,Schmidt,40,0,388,1750,0.2,Schmidt,40,0,388,1750,0.2,0,0,0,0,0.0
350,Aaronson,5.5,5.5,0.0,-880,-880,Aaronson,55,0,348,1228,0.1,Aaronson,55,0,348,1228,0.1,0,0,0,0,0.0
351,Gnonto,5.5,5.5,0.0,-3453,-3453,Gnonto,55,0,1777,5230,0.3,Gnonto,55,0,1777,5230,0.3,0,0,0,0,0.0
352,Harrison,5.5,5.5,0.0,-2364,-2364,Harrison,55,0,232,2596,0.1,Harrison,55,0,232,2596,0.1,0,0,0,0,0.0
353,James,5.5,5.5,0.0,-5030,-5030,James,55,0,1452,6482,0.5,James,55,0,1452,6482,0.5,0,0,0,0,0.0
354,Ampadu,5.0,5.0,0.0,-918,-918,Ampadu,50,0,580,1498,0.1,Ampadu,50,0,580,1498,0.1,0,0,0,0,0.0
355,Greenwood,5.0,5.0,0.0,-1415,-1415,Greenwood,50,0,442,1857,0.1,Greenwood,50,0,442,1857,0.1,0,0,0,0,0.0
356,Gruev,5.0,5.0,0.0,-508,-508,Gruev,50,0,112,620,0.0,Gruev,50,0,112,620,0.0,0,0,0,0,0.0
357,Ramazani,5.0,5.0,0.0,-729,-729,Ramazani,50,0,76,805,0.0,Ramazani,50,0,76,805,0.0,0,0,0,0,0.0
358,Tanaka,5.0,5.0,0.0,-292,-292,Tanaka,50,0,2580,2872,0.3,Tanaka,50,0,2580,2872,0.3,0,0,0,0,0.0
359,Crew,4.5,4.5,0.0,-341,-341,Crew,45,0,0,341,0.0,Crew,45,0,0,341,0.0,0,0,0,0,0.0
360,Gelhardt,4.5,4.5,0.0,-987,-987,Gelhardt,45,0,0,987,0.0,Gelhardt,45,0,0,987,0.0,0,0,0,0,0.0
361,Gyabi,4.5,4.5,0.0,-518,-518,Gyabi,45,0,660,1178,0.1,Gyabi,45,0,660,1178,0.1,0,0,0,0,0.0
362,Piroe,5.5,5.5,0.0,-15841,-15841,Piroe,55,0,8564,24405,1.8,Piroe,55,0,8564,24405,1.8,0,0,0,0,0.0
363,Bamford,5.0,5.0,0.0,-25245,-25245,Bamford,50,0,9649,34894,1.8,Bamford,50,0,9649,34894,1.8,0,0,0,0,0.0
364,Mateo Joseph,5.0,5.0,0.0,-1083,-1083,Mateo Joseph,50,0,0,1083,0.0,Mateo Joseph,50,0,0,1083,0.0,0,0,0,0,0.0
365,Nmecha,5.0,5.0,0.0,14482,14482,Nmecha,50,0,22977,8495,0.6,Nmecha,50,0,22977,8495,0.6,0,0,0,0,0.0
493,Longstaff,5.0,5.0,0.0,-2033,-2033,Longstaff,50,0,398,2431,0.2,Longstaff,50,0,398,2431,0.2,0,0,0,0,0.0
660,Stach,5.0,5.0,0.0,9803,9803,Stach,50,0,14122,4319,0.4,Stach,50,0,14122,4319,0.4,0,0,0,0,0.0
665,Perri,4.5,4.5,0.0,2031,2031,Perri,45,0,4670,2639,0.4,Perri,45,0,4670,2639,0.4,0,0,0,0,0.0
691,Calvert-Lewin,5.5,5.5,0.0,2543,2543,Calvert-Lewin,55,0,3244,701,0.1,Calvert-Lewin,55,0,3244,701,0.1,0,0,0,0,0.0
698,Okafor,5.5,5.5,0.0,268,268,Okafor,55,0,319,51,0.0,Okafor,55,0,319,51,0.0,0,0,0,0,0.0
366,A.Becker,5.5,5.5,0.0,-84143,-84143,A.Becker,55,0,18456,102599,10.8,A.Becker,55,0,18456,102599,10.8,0,0,0,0,0.0
367,Mamardashvili,4.5,4.5,0.0,-7488,-7488,Mamardashvili,45,0,1084,8572,0.4,Mamardashvili,45,0,1084,8572,0.4,0,0,0,0,0.0
368,Pécsi,4.0,4.0,0.0,-419,-419,Pécsi,40,0,266,685,0.1,Pécsi,40,0,266,685,0.1,0,0,0,0,0.0
369,Woodman,4.0,4.0,0.0,-474,-474,Woodman,40,0,306,780,0.1,Woodman,40,0,306,780,0.1,0,0,0,0,0.0
370,Frimpong,6.0,6.0,0.0,-821415,-821415,Frimpong,60,0,54395,875810,22.5,Frimpong,60,0,54395,875810,22.5,0,0,0,0,0.0
371,Kerkez,6.0,6.0,0.0,-75699,-75699,Kerkez,60,0,23268,98967,6.1,Kerkez,60,0,23268,98967,6.1,0,0,0,0,0.0
372,Robertson,6.0,6.0,0.0,-18082,-18082,Robertson,60,0,2290,20372,1.3,Robertson,60,0,2290,20372,1.3,0,0,0,0,0.0
373,Virgil,6.0,6.0,0.0,-15108,-15108,Virgil,60,0,111874,126982,24.0,Virgil,60,0,111874,126982,24.0,0,0,0,0,0.0
374,Konaté,5.5,5.5,0.0,-20060,-20060,Konaté,55,0,16107,36167,2.9,Konaté,55,0,16107,36167,2.9,0,0,0,0,0.0
375,Bradley,5.0,5.0,0.0,-3106,-3106,Bradley,50,0,565,3671,0.1,Bradley,50,0,565,3671,0.1,0,0,0,0,0.0
376,Gomez,5.0,5.0,0.0,142,142,Gomez,50,0,1222,1080,0.1,Gomez,50,0,1222,1080,0.1,0,0,0,0,0.0
377,Tsimikas,5.0,5.0,0.0,-1962,-1962,Tsimikas,50,0,426,2388,0.1,Tsimikas,50,0,426,2388,0.1,0,0,0,0,0.0
378,Nallo,4.0,4.0,0.0,-1116,-1116,Nallo,40,0,172,1288,0.1,Nallo,40,0,172,1288,0.1,0,0,0,0,0.0
379,R.Williams,4.0,4.0,0.0,-1629,-1629,R.Williams,40,0,469,2098,0.2,R.Williams,40,0,469,2098,0.2,0,0,0,0,0.0
380,Ramsay,4.0,4.0,0.0,-1599,-1599,Ramsay,40,0,527,2126,0.2,Ramsay,40,0,527,2126,0.2,0,0,0,0,0.0
381,M.Salah,14.5,14.5,0.0,8678,8678,M.Salah,145,0,135094,126416,53.6,M.Salah,145,0,135094,126416,53.6,0,0,0,0,0.0
382,Wirtz,8.5,8.5,0.0,-460980,-460980,Wirtz,85,0,42171,503151,28.2,Wirtz,85,0,42171,503151,28.2,0,0,0,0,0.0
383,Luis Díaz,8.0,8.0,0.0,-4261,-4261,Luis Díaz,80,0,0,4261,0.1,Luis Díaz,80,0,0,4261,0.1,0,0,0,0,0.0
384,Gakpo,7.5,7.5,0.0,74618,74618,Gakpo,75,0,146505,71887,8.4,Gakpo,75,0,146505,71887,8.4,0,0,0,0,0.0
385,Chiesa,6.5,6.5,0.0,5765,5765,Chiesa,65,0,8070,2305,0.3,Chiesa,65,0,8070,2305,0.3,0,0,0,0,0.0
386,Mac Allister,6.5,6.5,0.0,734,734,Mac Allister,65,0,19788,19054,2.0,Mac Allister,65,0,19788,19054,2.0,0,0,0,0,0.0
387,Szoboszlai,6.5,6.5,0.0,-24072,-24072,Szoboszlai,65,0,7410,31482,1.9,Szoboszlai,65,0,7410,31482,1.9,0,0,0,0,0.0
388,C.Jones,5.5,5.5,0.0,-2022,-2022,C.Jones,55,0,418,2440,0.1,C.Jones,55,0,418,2440,0.1,0,0,0,0,0.0
389,Elliott,5.4,5.4,0.0,-3062,-3062,Elliott,54,-1,518,3580,0.1,Elliott,54,-1,518,3580,0.1,0,0,0,0,0.0
390,Gravenberch,5.5,5.5,0.0,1745,1745,Gravenberch,55,0,4008,2263,0.2,Gravenberch,55,0,4008,2263,0.2,0,0,0,0,0.0
392,Endo,5.0,5.0,0.0,70,70,Endo,50,0,1590,1520,0.1,Endo,50,0,1590,1520,0.1,0,0,0,0,0.0
393,Bajcetic,4.5,4.5,0.0,-482,-482,Bajcetic,45,0,299,781,0.0,Bajcetic,45,0,299,781,0.0,0,0,0,0,0.0
394,McConnell,4.5,4.5,0.0,-340,-340,McConnell,45,0,132,472,0.0,McConnell,45,0,132,472,0.0,0,0,0,0,0.0
395,Morton,4.5,4.5,0.0,-144,-144,Morton,45,0,0,144,0.0,Morton,45,0,0,144,0.0,0,0,0,0,0.0
396,Nyoni,4.5,4.5,0.0,-1071,-1071,Nyoni,45,0,483,1554,0.1,Nyoni,45,0,483,1554,0.1,0,0,0,0,0.0
397,Darwin,6.5,6.5,0.0,-10190,-10190,Darwin,65,0,0,10190,0.1,Darwin,65,0,0,10190,0.1,0,0,0,0,0.0
398,Danns,4.5,4.5,0.0,-1500,-1500,Danns,45,0,859,2359,0.1,Danns,45,0,859,2359,0.1,0,0,0,0,0.0
661,Ekitiké,8.6,8.6,0.0,488211,488211,Ekitiké,86,1,568472,80261,21.6,Ekitiké,86,1,568472,80261,21.6,0,0,0,0,0.0
686,Ngumoha,4.5,4.5,0.0,4208,4208,Ngumoha,45,0,6303,2095,0.1,Ngumoha,45,0,6303,2095,0.1,0,0,0,0,0.0
692,Leoni,5.0,5.0,0.0,214,214,Leoni,50,0,317,103,0.0,Leoni,50,0,317,103,0.0,0,0,0,0,0.0
182,Trafford,5.0,5.0,0.0,28198,28198,Trafford,50,0,51726,23528,2.6,Trafford,50,0,51726,23528,2.6,0,0,0,0,0.0
399,Ederson M.,5.4,5.4,0.0,-62891,-62891,Ederson M.,54,-1,6459,69350,2.6,Ederson M.,54,-1,6459,69350,2.6,0,0,0,0,0.0
400,Ortega Moreno,5.0,5.0,0.0,-3571,-3571,Ortega Moreno,50,0,388,3959,0.2,Ortega Moreno,50,0,388,3959,0.2,0,0,0,0,0.0
401,Bettinelli,4.0,4.0,0.0,-818,-818,Bettinelli,40,0,701,1519,0.2,Bettinelli,40,0,701,1519,0.2,0,0,0,0,0.0
402,Aït-Nouri,6.0,6.0,0.0,222653,222653,Aït-Nouri,60,0,312794,90141,23.1,Aït-Nouri,60,0,312794,90141,23.1,0,0,0,0,0.0
403,Gvardiol,5.9,5.9,0.0,-427211,-427211,Gvardiol,59,-1,1268,428479,6.2,Gvardiol,59,-1,1268,428479,6.2,0,0,0,0,0.0
404,Akanji,5.5,5.5,0.0,-12953,-12953,Akanji,55,0,4263,17216,0.8,Akanji,55,0,4263,17216,0.8,0,0,0,0,0.0
405,Aké,5.5,5.5,0.0,-8613,-8613,Aké,55,0,2702,11315,0.7,Aké,55,0,2702,11315,0.7,0,0,0,0,0.0
406,Khusanov,5.5,5.5,0.0,-5100,-5100,Khusanov,55,0,1769,6869,0.4,Khusanov,55,0,1769,6869,0.4,0,0,0,0,0.0
407,Matheus N.,5.5,5.5,0.0,-7222,-7222,Matheus N.,55,0,1691,8913,0.4,Matheus N.,55,0,1691,8913,0.4,0,0,0,0,0.0
408,Rúben,5.5,5.5,0.0,18932,18932,Rúben,55,0,42366,23434,3.7,Rúben,55,0,42366,23434,3.7,0,0,0,0,0.0
409,Stones,5.5,5.5,0.0,6835,6835,Stones,55,0,11790,4955,0.9,Stones,55,0,11790,4955,0.9,0,0,0,0,0.0
410,Lewis,5.0,5.0,0.0,164453,164453,Lewis,50,0,190788,26335,3.3,Lewis,50,0,190788,26335,3.3,0,0,0,0,0.0
411,O’Reilly,5.0,5.0,0.0,-2141,-2141,O’Reilly,50,0,1086,3227,0.2,O’Reilly,50,0,1086,3227,0.2,0,0,0,0,0.0
412,Vitor Reis,5.0,5.0,0.0,-429,-429,Vitor Reis,50,0,0,429,0.0,Vitor Reis,50,0,0,429,0.0,0,0,0,0,0.0
413,Marmoush,8.4,8.4,0.0,-238678,-238678,Marmoush,84,-1,23179,261857,8.9,Marmoush,84,-1,23179,261857,8.9,0,0,0,0,0.0
414,Foden,8.0,8.0,0.0,-20650,-20650,Foden,80,0,6344,26994,1.3,Foden,80,0,6344,26994,1.3,0,0,0,0,0.0
415,Savinho,6.9,6.9,0.0,-43543,-43543,Savinho,69,-1,243,43786,0.7,Savinho,69,-1,243,43786,0.7,0,0,0,0,0.0
416,Bernardo,6.5,6.5,0.0,-7678,-7678,Bernardo,65,0,6236,13914,0.8,Bernardo,65,0,6236,13914,0.8,0,0,0,0,0.0
417,Cherki,6.5,6.5,0.0,10714,10714,Cherki,65,0,101578,90864,8.5,Cherki,65,0,101578,90864,8.5,0,0,0,0,0.0
418,Doku,6.5,6.5,0.0,-14855,-14855,Doku,65,0,7301,22156,1.1,Doku,65,0,7301,22156,1.1,0,0,0,0,0.0
420,Gündoğan,6.4,6.4,0.0,-4217,-4217,Gündoğan,64,-1,526,4743,0.2,Gündoğan,64,-1,526,4743,0.2,0,0,0,0,0.0
421,Rodrigo,6.4,6.4,0.0,-11301,-11301,Rodrigo,64,-1,3013,14314,0.6,Rodrigo,64,-1,3013,14314,0.6,0,0,0,0,0.0
422,Kovačić,6.0,6.0,0.0,-219,-219,Kovačić,60,0,73,292,0.0,Kovačić,60,0,73,292,0.0,0,0,0,0,0.0
423,N.Gonzalez,6.0,6.0,0.0,28,28,N.Gonzalez,60,0,1624,1596,0.1,N.Gonzalez,60,0,1624,1596,0.1,0,0,0,0,0.0
424,Bobb,5.5,5.5,0.0,17832,17832,Bobb,55,0,22986,5154,0.4,Bobb,55,0,22986,5154,0.4,0,0,0,0,0.0
425,Echeverri,5.4,5.4,0.0,-818,-818,Echeverri,54,-1,194,1012,0.0,Echeverri,54,-1,194,1012,0.0,0,0,0,0,0.0
427,Reijnders,5.6,5.6,0.0,1032798,1032798,Reijnders,56,1,1069750,36952,31.1,Reijnders,56,1,1069750,36952,31.1,0,0,0,0,0.0
428,Nypan,5.0,5.0,0.0,-836,-836,Nypan,50,0,73,909,0.0,Nypan,50,0,73,909,0.0,0,0,0,0,0.0
429,Phillips,5.0,5.0,0.0,-808,-808,Phillips,50,0,313,1121,0.1,Phillips,50,0,313,1121,0.1,0,0,0,0,0.0
430,Haaland,14.0,14.0,0.0,353035,353035,Haaland,140,0,395764,42729,29.8,Haaland,140,0,395764,42729,29.8,0,0,0,0,0.0
119,Mbeumo,8.0,8.0,0.0,41461,41461,Mbeumo,80,0,144851,103390,14.2,Mbeumo,80,0,144851,103390,14.2,0,0,0,0,0.0
431,Bayindir,5.0,5.0,0.0,-992,-992,Bayindir,50,0,3344,4336,0.4,Bayindir,50,0,3344,4336,0.4,0,0,0,0,0.0
432,Onana,5.0,5.0,0.0,-747,-747,Onana,50,0,2093,2840,0.3,Onana,50,0,2093,2840,0.3,0,0,0,0,0.0
433,Harrison,4.0,4.0,0.0,-77,-77,Harrison,40,0,0,77,0.0,Harrison,40,0,0,77,0.0,0,0,0,0,0.0
434,Heaton,4.0,4.0,0.0,-468,-468,Heaton,40,0,1317,1785,0.3,Heaton,40,0,1317,1785,0.3,0,0,0,0,0.0
435,Mee,4.0,4.0,0.0,-291,-291,Mee,40,0,371,662,0.1,Mee,40,0,371,662,0.1,0,0,0,0,0.0
436,De Ligt,5.0,5.0,0.0,27419,27419,De Ligt,50,0,43061,15642,2.3,De Ligt,50,0,43061,15642,2.3,0,0,0,0,0.0
437,Martinez,5.0,5.0,0.0,-6035,-6035,Martinez,50,0,121,6156,0.1,Martinez,50,0,121,6156,0.1,0,0,0,0,0.0
438,Mazraoui,5.0,5.0,0.0,-10250,-10250,Mazraoui,50,0,138,10388,0.2,Mazraoui,50,0,138,10388,0.2,0,0,0,0,0.0
439,D.Leon,4.5,4.5,0.0,-864,-864,D.Leon,45,0,298,1162,0.1,D.Leon,45,0,298,1162,0.1,0,0,0,0,0.0
440,Dalot,4.5,4.5,0.0,-6594,-6594,Dalot,45,0,9536,16130,2.2,Dalot,45,0,9536,16130,2.2,0,0,0,0,0.0
441,Dorgu,4.5,4.5,0.0,128073,128073,Dorgu,45,0,159610,31537,7.8,Dorgu,45,0,159610,31537,7.8,0,0,0,0,0.0
442,Maguire,4.5,4.5,0.0,-4505,-4505,Maguire,45,0,3615,8120,0.7,Maguire,45,0,3615,8120,0.7,0,0,0,0,0.0
443,Shaw,4.5,4.5,0.0,3203,3203,Shaw,45,0,5163,1960,0.3,Shaw,45,0,5163,1960,0.3,0,0,0,0,0.0
444,Yoro,4.5,4.5,0.0,18735,18735,Yoro,45,0,32857,14122,1.9,Yoro,45,0,32857,14122,1.9,0,0,0,0,0.0
445,Amass,4.0,4.0,0.0,-1261,-1261,Amass,40,0,597,1858,0.2,Amass,40,0,597,1858,0.2,0,0,0,0,0.0
446,Fredricson,4.0,4.0,0.0,-937,-937,Fredricson,40,0,201,1138,0.1,Fredricson,40,0,201,1138,0.1,0,0,0,0,0.0
447,Heaven,4.0,4.0,0.0,-8208,-8208,Heaven,40,0,4851,13059,1.5,Heaven,40,0,4851,13059,1.5,0,0,0,0,0.0
448,Malacia,4.0,4.0,0.0,-1851,-1851,Malacia,40,0,1315,3166,0.3,Malacia,40,0,1315,3166,0.3,0,0,0,0,0.0
449,B.Fernandes,9.0,9.0,0.0,-88206,-88206,B.Fernandes,90,0,71883,160089,21.1,B.Fernandes,90,0,71883,160089,21.1,0,0,0,0,0.0
450,Cunha,8.0,8.0,0.0,82621,82621,Cunha,80,0,145147,62526,9.1,Cunha,80,0,145147,62526,9.1,0,0,0,0,0.0
451,Rashford,7.0,7.0,0.0,-843,-843,Rashford,70,0,0,843,0.0,Rashford,70,0,0,843,0.0,0,0,0,0,0.0
452,Amad,6.5,6.5,0.0,-34469,-34469,Amad,65,0,11559,46028,2.7,Amad,65,0,11559,46028,2.7,0,0,0,0,0.0
453,Garnacho,6.5,6.5,0.0,-3174,-3174,Garnacho,65,0,734,3908,0.2,Garnacho,65,0,734,3908,0.2,0,0,0,0,0.0
454,Antony,6.0,6.0,0.0,-1893,-1893,Antony,60,0,572,2465,0.1,Antony,60,0,572,2465,0.1,0,0,0,0,0.0
455,Mount,6.0,6.0,0.0,30,30,Mount,60,0,4383,4353,0.3,Mount,60,0,4383,4353,0.3,0,0,0,0,0.0
456,Sancho,6.0,6.0,0.0,-2017,-2017,Sancho,60,0,513,2530,0.1,Sancho,60,0,513,2530,0.1,0,0,0,0,0.0
457,Casemiro,5.5,5.5,0.0,-1012,-1012,Casemiro,55,0,1952,2964,0.2,Casemiro,55,0,1952,2964,0.2,0,0,0,0,0.0
458,Mainoo,5.0,5.0,0.0,-9562,-9562,Mainoo,50,0,3713,13275,0.7,Mainoo,50,0,3713,13275,0.7,0,0,0,0,0.0
459,Ugarte,5.0,5.0,0.0,-1821,-1821,Ugarte,50,0,1362,3183,0.2,Ugarte,50,0,1362,3183,0.2,0,0,0,0,0.0
460,Collyer,4.5,4.5,0.0,-1876,-1876,Collyer,45,0,423,2299,0.1,Collyer,45,0,423,2299,0.1,0,0,0,0,0.0
461,Fitzgerald,4.5,4.5,0.0,-279,-279,Fitzgerald,45,0,152,431,0.0,Fitzgerald,45,0,152,431,0.0,0,0,0,0,0.0
462,J.Fletcher,4.5,4.5,0.0,-284,-284,J.Fletcher,45,0,178,462,0.0,J.Fletcher,45,0,178,462,0.0,0,0,0,0,0.0
463,Kone,4.5,4.5,0.0,-496,-496,Kone,45,0,592,1088,0.1,Kone,45,0,592,1088,0.1,0,0,0,0,0.0
464,Moorhouse,4.5,4.5,0.0,-228,-228,Moorhouse,45,0,139,367,0.0,Moorhouse,45,0,139,367,0.0,0,0,0,0,0.0
465,Højlund,6.4,6.4,0.0,-12183,-12183,Højlund,64,-1,2240,14423,0.6,Højlund,64,-1,2240,14423,0.6,0,0,0,0,0.0
466,Zirkzee,6.0,6.0,0.0,-3826,-3826,Zirkzee,60,0,3956,7782,0.4,Zirkzee,60,0,3956,7782,0.4,0,0,0,0,0.0
467,Obi,4.5,4.5,0.0,-16704,-16704,Obi,45,0,7477,24181,2.1,Obi,45,0,7477,24181,2.1,0,0,0,0,0.0
468,Wheatley,4.5,4.5,0.0,-1127,-1127,Wheatley,45,0,714,1841,0.1,Wheatley,45,0,714,1841,0.1,0,0,0,0,0.0
681,Šeško,7.5,7.5,0.0,8438,8438,Šeško,75,0,101873,93435,8.9,Šeško,75,0,101873,93435,8.9,0,0,0,0,0.0
52,J.Ramsey,5.5,5.5,0.0,-9104,-9104,J.Ramsey,55,0,3458,12562,0.6,J.Ramsey,55,0,3458,12562,0.6,0,0,0,0,0.0
469,Pope,5.0,5.0,0.0,15895,15895,Pope,50,0,39317,23422,4.1,Pope,50,0,39317,23422,4.1,0,0,0,0,0.0
471,Gillespie,4.0,4.0,0.0,-334,-334,Gillespie,40,0,568,902,0.2,Gillespie,40,0,568,902,0.2,0,0,0,0,0.0
472,Odysseas,4.0,4.0,0.0,-699,-699,Odysseas,40,0,0,699,0.0,Odysseas,40,0,0,699,0.0,0,0,0,0,0.0
473,Hall,5.5,5.5,0.0,-30976,-30976,Hall,55,0,5112,36088,1.7,Hall,55,0,5112,36088,1.7,0,0,0,0,0.0
474,Schär,5.5,5.5,0.0,11260,11260,Schär,55,0,26491,15231,2.9,Schär,55,0,26491,15231,2.9,0,0,0,0,0.0
475,Botman,5.0,5.0,0.0,-7022,-7022,Botman,50,0,1844,8866,0.4,Botman,50,0,1844,8866,0.4,0,0,0,0,0.0
476,Burn,5.0,5.0,0.0,26272,26272,Burn,50,0,49472,23200,4.1,Burn,50,0,49472,23200,4.1,0,0,0,0,0.0
477,Livramento,5.0,5.0,0.0,34418,34418,Livramento,50,0,57323,22905,4.1,Livramento,50,0,57323,22905,4.1,0,0,0,0,0.0
478,Trippier,5.0,5.0,0.0,7667,7667,Trippier,50,0,20062,12395,2.2,Trippier,50,0,20062,12395,2.2,0,0,0,0,0.0
479,Krafth,4.5,4.5,0.0,-539,-539,Krafth,45,0,150,689,0.0,Krafth,45,0,150,689,0.0,0,0,0,0,0.0
480,Lascelles,4.5,4.5,0.0,-932,-932,Lascelles,45,0,203,1135,0.1,Lascelles,45,0,203,1135,0.1,0,0,0,0,0.0
481,A.Murphy,4.0,4.0,0.0,-4451,-4451,A.Murphy,40,0,4085,8536,0.8,A.Murphy,40,0,4085,8536,0.8,0,0,0,0,0.0
482,Ashby,4.0,4.0,0.0,-1044,-1044,Ashby,40,0,279,1323,0.1,Ashby,40,0,279,1323,0.1,0,0,0,0,0.0
483,Pivas,4.0,4.0,0.0,-1038,-1038,Pivas,40,0,210,1248,0.1,Pivas,40,0,210,1248,0.1,0,0,0,0,0.0
484,Targett,4.0,4.0,0.0,-3004,-3004,Targett,40,0,1790,4794,0.5,Targett,40,0,1790,4794,0.5,0,0,0,0,0.0
485,Gordon,7.5,7.5,0.0,4987,4987,Gordon,75,0,31367,26380,2.0,Gordon,75,0,31367,26380,2.0,0,0,0,0,0.0
486,Elanga,7.0,7.0,0.0,-95562,-95562,Elanga,70,0,20009,115571,7.2,Elanga,70,0,20009,115571,7.2,0,0,0,0,0.0
487,Barnes,6.5,6.5,0.0,-5542,-5542,Barnes,65,0,3787,9329,0.5,Barnes,65,0,3787,9329,0.5,0,0,0,0,0.0
488,Bruno G.,6.5,6.5,0.0,-18366,-18366,Bruno G.,65,0,4113,22479,1.6,Bruno G.,65,0,4113,22479,1.6,0,0,0,0,0.0
489,J.Murphy,6.4,6.4,0.0,-52096,-52096,J.Murphy,64,-1,1330,53426,1.8,J.Murphy,64,-1,1330,53426,1.8,0,0,0,0,0.0
490,Joelinton,6.0,6.0,0.0,-5524,-5524,Joelinton,60,0,2778,8302,0.4,Joelinton,60,0,2778,8302,0.4,0,0,0,0,0.0
491,Tonali,5.5,5.5,0.0,-18590,-18590,Tonali,55,0,7124,25714,1.8,Tonali,55,0,7124,25714,1.8,0,0,0,0,0.0
492,Antoñito C.,5.0,5.0,0.0,-501,-501,Antoñito C.,50,0,127,628,0.0,Antoñito C.,50,0,127,628,0.0,0,0,0,0,0.0
494,Willock,5.0,5.0,0.0,-1115,-1115,Willock,50,0,29,1144,0.0,Willock,50,0,29,1144,0.0,0,0,0,0,0.0
495,Hayden,4.5,4.5,0.0,-593,-593,Hayden,45,0,0,593,0.0,Hayden,45,0,0,593,0.0,0,0,0,0,0.0
496,Kuol,4.5,4.5,0.0,-525,-525,Kuol,45,0,348,873,0.1,Kuol,45,0,348,873,0.1,0,0,0,0,0.0
497,L.Miley,4.5,4.5,0.0,-10762,-10762,L.Miley,45,0,14310,25072,2.5,L.Miley,45,0,14310,25072,2.5,0,0,0,0,0.0
498,White,4.5,4.5,0.0,-436,-436,White,45,0,0,436,0.0,White,45,0,0,436,0.0,0,0,0,0,0.0
499,Isak,10.4,10.4,0.0,-338866,-338866,Isak,104,-1,5257,344123,5.1,Isak,104,-1,5257,344123,5.1,0,0,0,0,0.0
500,Osula,5.5,5.5,0.0,-2233,-2233,Osula,55,0,1945,4178,0.2,Osula,55,0,1945,4178,0.2,0,0,0,0,0.0
501,Neave,4.5,4.5,0.0,-1602,-1602,Neave,45,0,1756,3358,0.2,Neave,45,0,1756,3358,0.2,0,0,0,0,0.0
674,Ramsdale,5.0,5.0,0.0,-12064,-12064,Ramsdale,50,0,1732,13796,0.8,Ramsdale,50,0,1732,13796,0.8,0,0,0,0,0.0
684,Thiaw,5.0,5.0,0.0,-1588,-1588,Thiaw,50,0,1260,2848,0.2,Thiaw,50,0,1260,2848,0.2,0,0,0,0,0.0
689,Seung soo,4.5,4.5,0.0,4794,4794,Seung soo,45,0,6838,2044,0.2,Seung soo,45,0,6838,2044,0.2,0,0,0,0,0.0
426,McAtee,5.5,5.5,0.0,-708,-708,McAtee,55,0,2566,3274,0.2,McAtee,55,0,2566,3274,0.2,0,0,0,0,0.0
502,Sels,5.0,5.0,0.0,-61861,-61861,Sels,50,0,46339,108200,19.2,Sels,50,0,46339,108200,19.2,0,0,0,0,0.0
503,C.Miguel,4.0,4.0,0.0,-1694,-1694,C.Miguel,40,0,448,2142,0.2,C.Miguel,40,0,448,2142,0.2,0,0,0,0,0.0
504,Turner,4.0,4.0,0.0,-4351,-4351,Turner,40,0,0,4351,0.2,Turner,40,0,0,4351,0.2,0,0,0,0,0.0
505,Milenković,5.5,5.5,0.0,-29323,-29323,Milenković,55,0,31074,60397,9.5,Milenković,55,0,31074,60397,9.5,0,0,0,0,0.0
506,Murillo,5.5,5.5,0.0,-18214,-18214,Murillo,55,0,20031,38245,6.6,Murillo,55,0,20031,38245,6.6,0,0,0,0,0.0
507,Aina,5.0,5.0,0.0,14018,14018,Aina,50,0,83740,69722,14.5,Aina,50,0,83740,69722,14.5,0,0,0,0,0.0
508,N.Williams,5.0,5.0,0.0,-27187,-27187,N.Williams,50,0,31132,58319,9.8,N.Williams,50,0,31132,58319,9.8,0,0,0,0,0.0
509,David Carmo,4.5,4.5,0.0,-409,-409,David Carmo,45,0,179,588,0.0,David Carmo,45,0,179,588,0.0,0,0,0,0,0.0
510,Jair Cunha,4.5,4.5,0.0,-753,-753,Jair Cunha,45,0,293,1046,0.1,Jair Cunha,45,0,293,1046,0.1,0,0,0,0,0.0
511,Morato,4.5,4.5,0.0,-935,-935,Morato,45,0,246,1181,0.1,Morato,45,0,246,1181,0.1,0,0,0,0,0.0
512,O.Richards,4.5,4.5,0.0,-414,-414,O.Richards,45,0,168,582,0.0,O.Richards,45,0,168,582,0.0,0,0,0,0,0.0
513,Abbott,4.0,4.0,0.0,-1061,-1061,Abbott,40,0,758,1819,0.2,Abbott,40,0,758,1819,0.2,0,0,0,0,0.0
514,Boly,4.0,4.0,0.0,-2386,-2386,Boly,40,0,1901,4287,0.5,Boly,40,0,1901,4287,0.5,0,0,0,0,0.0
515,Gibbs-White,7.5,7.5,0.0,-14244,-14244,Gibbs-White,75,0,30022,44266,5.1,Gibbs-White,75,0,30022,44266,5.1,0,0,0,0,0.0
516,Hudson-Odoi,6.0,6.0,0.0,-10677,-10677,Hudson-Odoi,60,0,6517,17194,1.1,Hudson-Odoi,60,0,6517,17194,1.1,0,0,0,0,0.0
517,Anderson,5.5,5.5,0.0,-5528,-5528,Anderson,55,0,53578,59106,6.4,Anderson,55,0,53578,59106,6.4,0,0,0,0,0.0
518,Jota,5.5,5.5,0.0,-963,-963,Jota,55,0,317,1280,0.1,Jota,55,0,317,1280,0.1,0,0,0,0,0.0
519,Dominguez,5.0,5.0,0.0,-17,-17,Dominguez,50,0,17,34,0.0,Dominguez,50,0,17,34,0.0,0,0,0,0,0.0
520,O'Brien,5.0,5.0,0.0,-53,-53,O'Brien,50,0,0,53,0.0,O'Brien,50,0,0,53,0.0,0,0,0,0,0.0
521,Sangaré,5.0,5.0,0.0,-241,-241,Sangaré,50,0,483,724,0.1,Sangaré,50,0,483,724,0.1,0,0,0,0,0.0
522,Yates,5.0,5.0,0.0,-1391,-1391,Yates,50,0,351,1742,0.1,Yates,50,0,351,1742,0.1,0,0,0,0,0.0
523,Da Silva Moreira,4.5,4.5,0.0,-1197,-1197,Da Silva Moreira,45,0,994,2191,0.2,Da Silva Moreira,45,0,994,2191,0.2,0,0,0,0,0.0
524,Stamenic,4.5,4.5,0.0,-941,-941,Stamenic,45,0,245,1186,0.1,Stamenic,45,0,245,1186,0.1,0,0,0,0,0.0
525,Wood,7.6,7.6,0.0,504434,504434,Wood,76,1,584040,79606,19.4,Wood,76,1,584040,79606,19.4,0,0,0,0,0.0
526,Igor Jesus,6.0,6.0,0.0,-12954,-12954,Igor Jesus,60,0,3296,16250,0.7,Igor Jesus,60,0,3296,16250,0.7,0,0,0,0,0.0
527,Awoniyi,5.5,5.5,0.0,-10100,-10100,Awoniyi,55,0,4085,14185,0.7,Awoniyi,55,0,4085,14185,0.7,0,0,0,0,0.0
669,Ndoye,6.0,6.0,0.0,26438,26438,Ndoye,60,0,37639,11201,0.8,Ndoye,60,0,37639,11201,0.8,0,0,0,0,0.0
675,Gunn,4.0,4.0,0.0,74,74,Gunn,40,0,7605,7531,1.9,Gunn,40,0,7605,7531,1.9,0,0,0,0,0.0
693,Hutchinson,5.5,5.5,0.0,436,436,Hutchinson,55,0,585,149,0.0,Hutchinson,55,0,585,149,0.0,0,0,0,0,0.0
696,Kalimuendo,6.0,6.0,0.0,522,522,Kalimuendo,60,0,650,128,0.0,Kalimuendo,60,0,650,128,0.0,0,0,0,0,0.0
252,Marc Guiu,4.5,4.5,0.0,-17625,-17625,Marc Guiu,45,0,100811,118436,19.5,Marc Guiu,45,0,100811,118436,19.5,0,0,0,0,0.0
528,Patterson,4.5,4.5,0.0,-3294,-3294,Patterson,45,0,2232,5526,0.3,Patterson,45,0,2232,5526,0.3,0,0,0,0,0.0
529,Moore,4.0,4.0,0.0,-879,-879,Moore,40,0,1869,2748,0.5,Moore,40,0,1869,2748,0.5,0,0,0,0,0.0
530,Nna Noukeu,4.0,4.0,0.0,-512,-512,Nna Noukeu,40,0,321,833,0.2,Nna Noukeu,40,0,321,833,0.2,0,0,0,0,0.0
531,Ballard,4.6,4.6,0.0,408015,408015,Ballard,46,1,435205,27190,5.8,Ballard,46,1,435205,27190,5.8,0,0,0,0,0.0
532,Hume,4.5,4.5,0.0,6775,6775,Hume,45,0,9160,2385,0.3,Hume,45,0,9160,2385,0.3,0,0,0,0,0.0
533,Alese,4.0,4.0,0.0,-38,-38,Alese,40,0,55,93,0.0,Alese,40,0,55,93,0.0,0,0,0,0,0.0
534,Anderson,4.0,4.0,0.0,-2791,-2791,Anderson,40,0,2189,4980,0.5,Anderson,40,0,2189,4980,0.5,0,0,0,0,0.0
535,Cirkin,4.0,4.0,0.0,-357,-357,Cirkin,40,0,65,422,0.0,Cirkin,40,0,65,422,0.0,0,0,0,0,0.0
536,Hjelde,4.0,4.0,0.0,-39,-39,Hjelde,40,0,55,94,0.0,Hjelde,40,0,55,94,0.0,0,0,0,0,0.0
537,Huggins,4.0,4.0,0.0,-1377,-1377,Huggins,40,0,616,1993,0.2,Huggins,40,0,616,1993,0.2,0,0,0,0,0.0
538,Johnson,4.0,4.0,0.0,-1461,-1461,Johnson,40,0,722,2183,0.2,Johnson,40,0,722,2183,0.2,0,0,0,0,0.0
539,O'Nien,4.0,4.0,0.0,-161,-161,O'Nien,40,0,152,313,0.0,O'Nien,40,0,152,313,0.0,0,0,0,0,0.0
540,Pembele,4.0,4.0,0.0,-1233,-1233,Pembele,40,0,676,1909,0.2,Pembele,40,0,676,1909,0.2,0,0,0,0,0.0
541,Reinildo,4.0,4.0,0.0,117751,117751,Reinildo,40,0,154964,37213,8.3,Reinildo,40,0,154964,37213,8.3,0,0,0,0,0.0
542,Seelt,4.0,4.0,0.0,-2206,-2206,Seelt,40,0,1383,3589,0.3,Seelt,40,0,1383,3589,0.3,0,0,0,0,0.0
543,Adingra,5.5,5.5,0.0,25724,25724,Adingra,55,0,43149,17425,1.9,Adingra,55,0,43149,17425,1.9,0,0,0,0,0.0
544,Diarra,5.5,5.5,0.0,780,780,Diarra,55,0,2270,1490,0.1,Diarra,55,0,2270,1490,0.1,0,0,0,0,0.0
545,Roberts,5.4,5.4,0.0,-797,-797,Roberts,54,-1,128,925,0.0,Roberts,54,-1,128,925,0.0,0,0,0,0,0.0
546,Aleksić,5.0,5.0,0.0,-484,-484,Aleksić,50,0,139,623,0.0,Aleksić,50,0,139,623,0.0,0,0,0,0,0.0
547,E.Le Fée,5.0,5.0,0.0,-5447,-5447,E.Le Fée,50,0,562,6009,0.3,E.Le Fée,50,0,562,6009,0.3,0,0,0,0,0.0
548,Mundle,5.0,5.0,0.0,-255,-255,Mundle,50,0,26,281,0.0,Mundle,50,0,26,281,0.0,0,0,0,0,0.0
549,Neil,5.0,5.0,0.0,-492,-492,Neil,50,0,77,569,0.0,Neil,50,0,77,569,0.0,0,0,0,0,0.0
550,Poveda,5.0,5.0,0.0,-377,-377,Poveda,50,0,35,412,0.0,Poveda,50,0,35,412,0.0,0,0,0,0,0.0
551,Rigg,5.0,5.0,0.0,-750,-750,Rigg,50,0,145,895,0.1,Rigg,50,0,145,895,0.1,0,0,0,0,0.0
552,Sadiki,5.0,5.0,0.0,299,299,Sadiki,50,0,801,502,0.1,Sadiki,50,0,801,502,0.1,0,0,0,0,0.0
553,Talbi,5.0,5.0,0.0,15386,15386,Talbi,50,0,20796,5410,0.4,Talbi,50,0,20796,5410,0.4,0,0,0,0,0.0
554,Ba,4.5,4.5,0.0,-1893,-1893,Ba,45,0,1466,3359,0.3,Ba,45,0,1466,3359,0.3,0,0,0,0,0.0
555,Browne,4.5,4.5,0.0,-571,-571,Browne,45,0,745,1316,0.1,Browne,45,0,745,1316,0.1,0,0,0,0,0.0
556,Ekwah,4.5,4.5,0.0,-633,-633,Ekwah,45,0,0,633,0.0,Ekwah,45,0,0,633,0.0,0,0,0,0,0.0
557,H.Jones,4.5,4.5,0.0,-422,-422,H.Jones,45,0,446,868,0.1,H.Jones,45,0,446,868,0.1,0,0,0,0,0.0
558,Matete,4.5,4.5,0.0,-1597,-1597,Matete,45,0,1904,3501,0.3,Matete,45,0,1904,3501,0.3,0,0,0,0,0.0
559,Triantis,4.5,4.5,0.0,-564,-564,Triantis,45,0,300,864,0.1,Triantis,45,0,300,864,0.1,0,0,0,0,0.0
560,Isidor,5.5,5.5,0.0,7717,7717,Isidor,55,0,11762,4045,0.4,Isidor,55,0,11762,4045,0.4,0,0,0,0,0.0
561,Mayenda,5.5,5.5,0.0,118000,118000,Mayenda,55,0,141051,23051,1.9,Mayenda,55,0,141051,23051,1.9,0,0,0,0,0.0
562,Abdullahi,4.5,4.5,0.0,-3540,-3540,Abdullahi,45,0,3076,6616,0.6,Abdullahi,45,0,3076,6616,0.6,0,0,0,0,0.0
563,Luís Hemir,4.5,4.5,0.0,-1224,-1224,Luís Hemir,45,0,1047,2271,0.2,Luís Hemir,45,0,1047,2271,0.2,0,0,0,0,0.0
564,Rusyn,4.5,4.5,0.0,-1334,-1334,Rusyn,45,0,1384,2718,0.2,Rusyn,45,0,1384,2718,0.2,0,0,0,0,0.0
668,Xhaka,5.0,5.0,0.0,3792,3792,Xhaka,50,0,29421,25629,2.9,Xhaka,50,0,29421,25629,2.9,0,0,0,0,0.0
670,Roefs,4.5,4.5,0.0,48216,48216,Roefs,45,0,58695,10479,1.0,Roefs,45,0,58695,10479,1.0,0,0,0,0,0.0
678,Masuaku,4.0,4.0,0.0,2430,2430,Masuaku,40,0,8008,5578,0.8,Masuaku,40,0,8008,5578,0.8,0,0,0,0,0.0
683,Alderete,4.0,4.0,0.0,21026,21026,Alderete,40,0,31331,10305,1.3,Alderete,40,0,31331,10305,1.3,0,0,0,0,0.0
694,Mukiele,4.0,4.0,0.0,9365,9365,Mukiele,40,0,11308,1943,0.3,Mukiele,40,0,11308,1943,0.3,0,0,0,0,0.0
565,Vicario,5.0,5.0,0.0,-12136,-12136,Vicario,50,0,32462,44598,4.3,Vicario,50,0,32462,44598,4.3,0,0,0,0,0.0
566,Austin,4.0,4.0,0.0,-1024,-1024,Austin,40,0,670,1694,0.3,Austin,40,0,670,1694,0.3,0,0,0,0,0.0
567,Kinsky,4.0,4.0,0.0,-8341,-8341,Kinsky,40,0,2995,11336,2.0,Kinsky,40,0,2995,11336,2.0,0,0,0,0,0.0
568,Pedro Porro,5.5,5.5,0.0,-16764,-16764,Pedro Porro,55,0,109907,126671,21.9,Pedro Porro,55,0,109907,126671,21.9,0,0,0,0,0.0
569,Romero,5.0,5.0,0.0,-5983,-5983,Romero,50,0,29155,35138,3.6,Romero,50,0,29155,35138,3.6,0,0,0,0,0.0
570,Danso,4.5,4.5,0.0,-3715,-3715,Danso,45,0,782,4497,0.2,Danso,45,0,782,4497,0.2,0,0,0,0,0.0
571,Davies,4.5,4.5,0.0,-1104,-1104,Davies,45,0,336,1440,0.1,Davies,45,0,336,1440,0.1,0,0,0,0,0.0
572,Dragusin,4.5,4.5,0.0,-58,-58,Dragusin,45,0,53,111,0.0,Dragusin,45,0,53,111,0.0,0,0,0,0,0.0
573,Spence,4.5,4.5,0.0,4244,4244,Spence,45,0,16200,11956,1.3,Spence,45,0,16200,11956,1.3,0,0,0,0,0.0
574,Udogie,4.5,4.5,0.0,-28058,-28058,Udogie,45,0,316,28374,0.6,Udogie,45,0,316,28374,0.6,0,0,0,0,0.0
575,Van de Ven,4.5,4.5,0.0,36095,36095,Van de Ven,45,0,146761,110666,27.1,Van de Ven,45,0,146761,110666,27.1,0,0,0,0,0.0
576,Phillips,4.0,4.0,0.0,-669,-669,Phillips,40,0,0,669,0.0,Phillips,40,0,0,669,0.0,0,0,0,0,0.0
577,Takai,4.0,4.0,0.0,-2035,-2035,Takai,40,0,103,2138,0.1,Takai,40,0,103,2138,0.1,0,0,0,0,0.0
578,Vuskovic,4.0,4.0,0.0,-7941,-7941,Vuskovic,40,0,3113,11054,1.0,Vuskovic,40,0,3113,11054,1.0,0,0,0,0,0.0
579,Son,8.5,8.5,0.0,-16015,-16015,Son,85,0,0,16015,0.2,Son,85,0,0,16015,0.2,0,0,0,0,0.0
580,Johnson,7.0,7.0,0.0,-13998,-13998,Johnson,70,0,19070,33068,2.9,Johnson,70,0,19070,33068,2.9,0,0,0,0,0.0
581,Maddison,7.0,7.0,0.0,-11093,-11093,Maddison,70,0,127,11220,0.2,Maddison,70,0,127,11220,0.2,0,0,0,0,0.0
582,Kudus,6.5,6.5,0.0,228602,228602,Kudus,65,0,339889,111287,27.7,Kudus,65,0,339889,111287,27.7,0,0,0,0,0.0
583,Kulusevski,6.5,6.5,0.0,-357,-357,Kulusevski,65,0,90,447,0.0,Kulusevski,65,0,90,447,0.0,0,0,0,0,0.0
584,Tel,6.4,6.4,0.0,-2689,-2689,Tel,64,-1,552,3241,0.1,Tel,64,-1,552,3241,0.1,0,0,0,0,0.0
585,Bentancur,5.5,5.5,0.0,-2681,-2681,Bentancur,55,0,761,3442,0.2,Bentancur,55,0,761,3442,0.2,0,0,0,0,0.0
586,Bergvall,5.5,5.5,0.0,-1095,-1095,Bergvall,55,0,953,2048,0.2,Bergvall,55,0,953,2048,0.2,0,0,0,0,0.0
587,Bissouma,5.4,5.4,0.0,-2750,-2750,Bissouma,54,-1,594,3344,0.1,Bissouma,54,-1,594,3344,0.1,0,0,0,0,0.0
588,Odobert,5.5,5.5,0.0,-693,-693,Odobert,55,0,116,809,0.0,Odobert,55,0,116,809,0.0,0,0,0,0,0.0
589,Solomon,5.5,5.5,0.0,-487,-487,Solomon,55,0,28,515,0.0,Solomon,55,0,28,515,0.0,0,0,0,0,0.0
590,Bryan,5.0,5.0,0.0,-696,-696,Bryan,50,0,120,816,0.0,Bryan,50,0,120,816,0.0,0,0,0,0,0.0
591,Gray,5.0,5.0,0.0,-960,-960,Gray,50,0,949,1909,0.1,Gray,50,0,949,1909,0.1,0,0,0,0,0.0
592,Moore,5.0,5.0,0.0,-324,-324,Moore,50,0,0,324,0.0,Moore,50,0,0,324,0.0,0,0,0,0,0.0
593,P.M.Sarr,5.0,5.0,0.0,3410,3410,P.M.Sarr,50,0,37521,34111,2.8,P.M.Sarr,50,0,37521,34111,2.8,0,0,0,0,0.0
594,Min-hyeok,4.5,4.5,0.0,-1077,-1077,Min-hyeok,45,0,0,1077,0.0,Min-hyeok,45,0,0,1077,0.0,0,0,0,0,0.0
595,Olusesi,4.5,4.5,0.0,-1752,-1752,Olusesi,45,0,985,2737,0.2,Olusesi,45,0,985,2737,0.2,0,0,0,0,0.0
596,Solanke,7.4,7.4,0.0,-102247,-102247,Solanke,74,-1,9430,111677,3.7,Solanke,74,-1,9430,111677,3.7,0,0,0,0,0.0
597,Richarlison,6.6,6.6,0.0,254885,254885,Richarlison,66,1,308214,53329,6.2,Richarlison,66,1,308214,53329,6.2,0,0,0,0,0.0
598,Lankshear,4.5,4.5,0.0,-1841,-1841,Lankshear,45,0,0,1841,0.1,Lankshear,45,0,0,1841,0.1,0,0,0,0,0.0
599,Scarlett,4.5,4.5,0.0,-5205,-5205,Scarlett,45,0,5718,10923,0.8,Scarlett,45,0,5718,10923,0.8,0,0,0,0,0.0
673,J.Palhinha,5.5,5.5,0.0,-7502,-7502,J.Palhinha,55,0,1163,8665,0.3,J.Palhinha,55,0,1163,8665,0.3,0,0,0,0,0.0
600,Areola,4.5,4.5,0.0,-60873,-60873,Areola,45,0,5595,66468,4.0,Areola,45,0,5595,66468,4.0,0,0,0,0,0.0
601,Foderingham,4.0,4.0,0.0,-1387,-1387,Foderingham,40,0,1749,3136,0.6,Foderingham,40,0,1749,3136,0.6,0,0,0,0,0.0
602,Hegyi,4.0,4.0,0.0,-826,-826,Hegyi,40,0,409,1235,0.3,Hegyi,40,0,409,1235,0.3,0,0,0,0,0.0
603,Diouf,4.5,4.5,0.0,-63580,-63580,Diouf,45,0,9363,72943,6.6,Diouf,45,0,9363,72943,6.6,0,0,0,0,0.0
604,Emerson,4.5,4.5,0.0,-3391,-3391,Emerson,45,0,337,3728,0.2,Emerson,45,0,337,3728,0.2,0,0,0,0,0.0
605,Kilman,4.5,4.5,0.0,-5281,-5281,Kilman,45,0,337,5618,0.3,Kilman,45,0,337,5618,0.3,0,0,0,0,0.0
606,Mavropanos,4.5,4.5,0.0,-725,-725,Mavropanos,45,0,99,824,0.1,Mavropanos,45,0,99,824,0.1,0,0,0,0,0.0
607,N.Aguerd,4.5,4.5,0.0,-1245,-1245,N.Aguerd,45,0,453,1698,0.1,N.Aguerd,45,0,453,1698,0.1,0,0,0,0,0.0
608,Scarles,4.5,4.5,0.0,-428,-428,Scarles,45,0,54,482,0.0,Scarles,45,0,54,482,0.0,0,0,0,0,0.0
609,Todibo,4.5,4.5,0.0,-1560,-1560,Todibo,45,0,477,2037,0.1,Todibo,45,0,477,2037,0.1,0,0,0,0,0.0
610,Wan-Bissaka,4.5,4.5,0.0,-223444,-223444,Wan-Bissaka,45,0,24328,247772,21.8,Wan-Bissaka,45,0,24328,247772,21.8,0,0,0,0,0.0
611,Casey,4.0,4.0,0.0,-3472,-3472,Casey,40,0,0,3472,0.2,Casey,40,0,0,3472,0.2,0,0,0,0,0.0
612,L.Paquetá,5.9,5.9,0.0,-23724,-23724,L.Paquetá,59,-1,3278,27002,0.9,L.Paquetá,59,-1,3278,27002,0.9,0,0,0,0,0.0
613,Souček,5.9,5.9,0.0,-20408,-20408,Souček,59,-1,586,20994,0.7,Souček,59,-1,586,20994,0.7,0,0,0,0,0.0
614,Ward-Prowse,6.0,6.0,0.0,-6618,-6618,Ward-Prowse,60,0,1243,7861,0.3,Ward-Prowse,60,0,1243,7861,0.3,0,0,0,0,0.0
615,Summerville,5.5,5.5,0.0,-196,-196,Summerville,55,0,53,249,0.0,Summerville,55,0,53,249,0.0,0,0,0,0,0.0
616,Álvarez,5.0,5.0,0.0,-2738,-2738,Álvarez,50,0,480,3218,0.2,Álvarez,50,0,480,3218,0.2,0,0,0,0,0.0
617,Cornet,5.0,5.0,0.0,-539,-539,Cornet,50,0,53,592,0.0,Cornet,50,0,53,592,0.0,0,0,0,0,0.0
618,G.Rodriguez,5.0,5.0,0.0,-451,-451,G.Rodriguez,50,0,204,655,0.1,G.Rodriguez,50,0,204,655,0.1,0,0,0,0,0.0
619,L.Guilherme,5.0,5.0,0.0,-550,-550,L.Guilherme,50,0,32,582,0.0,L.Guilherme,50,0,32,582,0.0,0,0,0,0,0.0
620,Earthy,4.5,4.5,0.0,-1817,-1817,Earthy,45,0,87,1904,0.1,Earthy,45,0,87,1904,0.1,0,0,0,0,0.0
621,Irving,4.5,4.5,0.0,-321,-321,Irving,45,0,2918,3239,0.3,Irving,45,0,2918,3239,0.3,0,0,0,0,0.0
622,Orford,4.5,4.5,0.0,-1347,-1347,Orford,45,0,526,1873,0.1,Orford,45,0,526,1873,0.1,0,0,0,0,0.0
623,Potts,4.5,4.5,0.0,-5784,-5784,Potts,45,0,2256,8040,0.7,Potts,45,0,2256,8040,0.7,0,0,0,0,0.0
624,Bowen,7.9,7.9,0.0,-344187,-344187,Bowen,79,-1,17125,361312,13.1,Bowen,79,-1,17125,361312,13.1,0,0,0,0,0.0
625,Füllkrug,6.0,6.0,0.0,-53114,-53114,Füllkrug,60,0,10076,63190,3.1,Füllkrug,60,0,10076,63190,3.1,0,0,0,0,0.0
626,Marshall,4.5,4.5,0.0,-3704,-3704,Marshall,45,0,6387,10091,0.7,Marshall,45,0,6387,10091,0.7,0,0,0,0,0.0
659,Walker-Peters,4.5,4.5,0.0,-4561,-4561,Walker-Peters,45,0,845,5406,0.4,Walker-Peters,45,0,845,5406,0.4,0,0,0,0,0.0
671,Wilson,6.0,6.0,0.0,-6711,-6711,Wilson,60,0,1822,8533,0.5,Wilson,60,0,1822,8533,0.5,0,0,0,0,0.0
679,Hermansen,4.5,4.5,0.0,-948,-948,Hermansen,45,0,2170,3118,0.3,Hermansen,45,0,2170,3118,0.3,0,0,0,0,0.0
627,Johnstone,4.5,4.5,0.0,-605,-605,Johnstone,45,0,458,1063,0.1,Johnstone,45,0,458,1063,0.1,0,0,0,0,0.0
628,José Sá,4.5,4.5,0.0,-6575,-6575,José Sá,45,0,5967,12542,1.9,José Sá,45,0,5967,12542,1.9,0,0,0,0,0.0
629,Bentley,4.0,4.0,0.0,-1256,-1256,Bentley,40,0,1846,3102,0.8,Bentley,40,0,1846,3102,0.8,0,0,0,0,0.0
631,Agbadou,4.5,4.5,0.0,156,156,Agbadou,45,0,2420,2264,0.4,Agbadou,45,0,2420,2264,0.4,0,0,0,0,0.0
632,Doherty,4.5,4.5,0.0,-911,-911,Doherty,45,0,879,1790,0.2,Doherty,45,0,879,1790,0.2,0,0,0,0,0.0
633,H.Bueno,4.5,4.5,0.0,-32,-32,H.Bueno,45,0,647,679,0.1,H.Bueno,45,0,647,679,0.1,0,0,0,0,0.0
634,Mosquera,4.5,4.5,0.0,-522,-522,Mosquera,45,0,178,700,0.1,Mosquera,45,0,178,700,0.1,0,0,0,0,0.0
635,R.Gomes,4.5,4.5,0.0,-117,-117,R.Gomes,45,0,551,668,0.1,R.Gomes,45,0,551,668,0.1,0,0,0,0,0.0
636,S.Bueno,4.5,4.5,0.0,-493,-493,S.Bueno,45,0,89,582,0.1,S.Bueno,45,0,89,582,0.1,0,0,0,0,0.0
637,Toti,4.5,4.5,0.0,-866,-866,Toti,45,0,751,1617,0.2,Toti,45,0,751,1617,0.2,0,0,0,0,0.0
638,Hoever,4.0,4.0,0.0,1176,1176,Hoever,40,0,15439,14263,2.3,Hoever,40,0,15439,14263,2.3,0,0,0,0,0.0
639,Meupiyou,4.0,4.0,0.0,-209,-209,Meupiyou,40,0,0,209,0.0,Meupiyou,40,0,0,209,0.0,0,0,0,0,0.0
640,Pedro Lima,4.0,4.0,0.0,-3852,-3852,Pedro Lima,40,0,4343,8195,1.1,Pedro Lima,40,0,4343,8195,1.1,0,0,0,0,0.0
641,Pond,4.0,4.0,0.0,-5385,-5385,Pond,40,0,5528,10913,1.5,Pond,40,0,5528,10913,1.5,0,0,0,0,0.0
642,Hee Chan,6.0,6.0,0.0,-2014,-2014,Hee Chan,60,0,818,2832,0.2,Hee Chan,60,0,818,2832,0.2,0,0,0,0,0.0
643,André,5.5,5.5,0.0,550,550,André,55,0,1493,943,0.1,André,55,0,1493,943,0.1,0,0,0,0,0.0
644,Bellegarde,5.5,5.5,0.0,-122,-122,Bellegarde,55,0,967,1089,0.1,Bellegarde,55,0,967,1089,0.1,0,0,0,0,0.0
645,Fer López,5.5,5.5,0.0,-577,-577,Fer López,55,0,117,694,0.0,Fer López,55,0,117,694,0.0,0,0,0,0,0.0
646,Gomes,5.5,5.5,0.0,-665,-665,Gomes,55,0,643,1308,0.1,Gomes,55,0,643,1308,0.1,0,0,0,0,0.0
647,Guedes,5.5,5.5,0.0,-412,-412,Guedes,55,0,0,412,0.0,Guedes,55,0,0,412,0.0,0,0,0,0,0.0
648,Munetsi,5.5,5.5,0.0,822,822,Munetsi,55,0,1589,767,0.1,Munetsi,55,0,1589,767,0.1,0,0,0,0,0.0
649,B.Traore,5.0,5.0,0.0,-73,-73,B.Traore,50,0,0,73,0.0,B.Traore,50,0,0,73,0.0,0,0,0,0,0.0
650,Chirewa,4.5,4.5,0.0,-2668,-2668,Chirewa,45,0,1212,3880,0.3,Chirewa,45,0,1212,3880,0.3,0,0,0,0,0.0
651,Edozie,4.5,4.5,0.0,-3075,-3075,Edozie,45,0,1505,4580,0.4,Edozie,45,0,1505,4580,0.4,0,0,0,0,0.0
652,Gonzalez,4.5,4.5,0.0,-11511,-11511,Gonzalez,45,0,6198,17709,1.5,Gonzalez,45,0,6198,17709,1.5,0,0,0,0,0.0
653,Hodge,4.5,4.5,0.0,-1586,-1586,Hodge,45,0,0,1586,0.1,Hodge,45,0,0,1586,0.1,0,0,0,0,0.0
654,Strand Larsen,6.5,6.5,0.0,-8013,-8013,Strand Larsen,65,0,38476,46489,4.6,Strand Larsen,65,0,38476,46489,4.6,0,0,0,0,0.0
655,Fábio Silva,5.0,5.0,0.0,-5176,-5176,Fábio Silva,50,0,3475,8651,0.6,Fábio Silva,50,0,3475,8651,0.6,0,0,0,0,0.0
656,Kalajdžić,5.0,5.0,0.0,-1150,-1150,Kalajdžić,50,0,436,1586,0.1,Kalajdžić,50,0,436,1586,0.1,0,0,0,0,0.0
657,Chiwome,4.5,4.5,0.0,6,6,Chiwome,45,0,950,944,0.0,Chiwome,45,0,950,944,0.0,0,0,0,0,0.0
658,Fraser,4.5,4.5,0.0,-3218,-3218,Fraser,45,0,24505,27723,2.5,Fraser,45,0,24505,27723,2.5,0,0,0,0,0.0
663,J.Arias,5.5,5.5,0.0,-10604,-10604,J.Arias,55,0,1540,12144,0.6,J.Arias,55,0,1540,12144,0.6,0,0,0,0,0.0
682,Møller Wolfe,4.5,4.5,0.0,234,234,Møller Wolfe,45,0,789,555,0.1,Møller Wolfe,45,0,789,555,0.1,0,0,0,0,0.0
695,Tchatchoua,4.5,4.5,0.0,152,152,Tchatchoua,45,0,187,35,0.0,Tchatchoua,45,0,187,35,0.0,0,0,0,0,0.0
